ああ	ああ
あいいく	愛育
あいいん	愛飲
あいいん	合印
あいかぎ	合鍵
あいかん	哀歓
あいがん	哀願
あいがん	愛翫
あいぎ	合着
あいきょう	愛郷
あいきょう	愛嬌
あいけん	愛犬
あいこ	愛顧
あいご	愛護
あいこう	愛好
あいこく	愛国
あいさい	愛妻
あいじ	愛児
あいじゃく	愛着
あいしゅう	哀愁
あいしょ	愛書
あいしょう	哀傷
あいしょう	愛称
あいしょう	愛誦
あいしょう	合性
あいじょう	愛情
あいじるし	合印
あいじん	愛人
あいず	合図
あいせき	愛惜
あいぜん	愛染
あいそう	愛想
あいだがら	間柄
あいちゃく	愛着
あいちょう	哀調
あいづち	合槌
あいて	相手
あいとう	哀悼
あいどく	愛読
あいば	愛馬
あいばん	合判
あいぶ	愛撫
あいふく	合服
あいぼ	愛慕
あいぼう	相棒
あいま	合間
あいやど	相宿
あいよう	愛用
あいよく	愛欲
あいらく	哀楽
あいろ	隘路
あいわ	哀話
あう	逢う
あう	会う
あう	合う
あえん	亜鉛
あおあお	青々
あおい	青い
あおいき	青息
あおき	青木
あおぐ	仰ぐ
あおぐ	扇ぐ
あおくさ	青草
あおぐも	青雲
あおすじ	青筋
あおぞら	青空
あおた	青田
あおな	青菜
あおば	青葉
あおもの	青物
あかあか	赤々
あかい	赤い
あかいろ	赤色
あかご	赤子
あかじ	赤字
あかせん	赤線
あかつち	赤土
あかはじ	赤恥
あかはた	赤旗
あかぼう	赤帽
あき	あき
あき	飽き
あきかぜ	秋風
あきくさ	秋草
あきぐち	秋口
あきさく	秋作
あきなう	商う
あきんど	商人
あく	あく
あくい	悪意
あくうん	悪運
あくえき	悪疫
あくえん	悪縁
あくぎょう	悪行
あくごう	悪業
あくさい	悪妻
あくじ	悪事
あくじき	悪食
あくしつ	悪疾
あくしつ	悪質
あくしゅ	握手
あくしゅう	悪習
あくしゅう	悪臭
あくしょう	悪性
あくしん	悪心
あくせい	悪性
あくせい	悪政
あくぜい	悪税
あくせん	悪戦
あくせん	悪銭
あくだま	悪玉
あくてん	悪天
あくとう	悪党
あくどう	悪童
あくとく	悪徳
あくにち	悪日
あくにん	悪人
あくば	悪罵
あくび	悪日
あくひつ	悪筆
あくひょう	悪評
あくびょう	悪病
あくふう	悪風
あくぶん	悪文
あくへい	悪弊
あくへき	悪癖
あくま	悪魔
あくみょう	悪名
あくむ	悪夢
あくめい	悪名
あくやく	悪役
あくゆう	悪友
あくよう	悪用
あくらつ	悪辣
あくりょう	悪霊
あくりょく	握力
あくれい	悪例
あくろ	悪路
あけ	明け
あげ	上げ
あげ	揚げ
あこ	あこ
あご	あご
あさ	あさ
あざ	あざ
あさい	浅い
あさがすみ	朝霞
あさかぜ	朝風
あさぎり	朝霧
あさけ	朝け
あさせ	浅瀬
あさづけ	浅漬
あさつゆ	朝露
あさで	浅手
あさね	朝寝
あさはん	朝飯
あさばん	朝晩
あさひ	朝日
あさみどり	浅緑
あさめし	朝飯
あさゆう	朝夕
あし	あし
あじ	あじ
あしあと	足跡
あしおと	足音
あしがる	足軽
あしくび	足首
あしげ	足蹴
あじけ	味気
あしげい	足芸
あしこし	足腰
あしだ	足駄
あしだい	足代
あしなが	足長
あしば	足場
あしばや	足早
あしゃ	唖者
あしよわ	足弱
あす	あす
あずけ	預け
あずまや	東屋
あぜ	あぜ
あせみず	汗水
あぜん	唖然
あそび	遊び
あそぶ	遊ぶ
あだ	あだ
あだうち	仇討
あたたか	暖か
あだなみ	仇波
あだばな	仇花
あたまかず	頭数
あたまかぶ	頭株
あっ	あっ
あつい	厚い
あつい	暑い
あつい	熱い
あついた	厚板
あつえん	圧延
あっか	悪化
あつかい	扱い
あつかう	扱う
あつがみ	厚紙
あっかん	悪漢
あっかん	圧巻
あっき	悪鬼
あつぎ	厚着
あっこう	悪口
あつさ	厚さ
あつさ	暑さ
あっさく	圧搾
あっし	圧死
あっしゅく	圧縮
あっしょう	圧勝
あっせい	圧制
あっせん	斡旋
あつで	厚手
あっとう	圧倒
あっぱく	圧迫
あっぷく	圧服
あつみ	厚み
あつゆ	熱湯
あつらえ	誂え
あつりょく	圧力
あて	あて
あと	あと
あとあし	後足
あとあじ	後味
あとかた	跡方
あとくち	後口
あとさき	後先
あとざん	後産
あとめ	跡目
あなぐら	穴倉
あなぐら	穴蔵
あにうえ	兄上
あにき	兄貴
あによめ	兄嫁
あねご	姐御
あの	あの
あぶ	あぶ
あぶらあせ	脂汗
あぶらえ	油絵
あぶらけ	油気
あほう	阿呆
あま	あま
あま	海人
あまあし	雨足
あまい	甘い
あまがき	甘柿
あまがさ	雨傘
あまから	甘辛
あまかわ	甘皮
あまぎ	雨着
あまぐ	雨具
あまくち	甘口
あまぐも	雨雲
あまぐり	甘栗
あまけ	雨気
あまざけ	甘酒
あます	余す
あまでら	尼寺
あまど	雨戸
あまどい	雨樋
あまとう	甘党
あまみ	甘味
あまみず	雨水
あまり	余り
あまる	余る
あみ	編み
あみだな	網棚
あみど	網戸
あみめ	網目
あむ	編む
あめかぜ	雨風
あめつち	天地
あめつゆ	雨露
あやまち	過ち
あやまつ	過つ
あやまり	誤り
あやまる	誤る
あやめ	文目
あゆ	あゆ
あゆ	阿諛
あゆみ	歩み
あゆむ	歩む
あゆりょう	鮎漁
あら	あら
あら	アラ
あらい	荒い
あらい	洗い
あらいそ	荒磯
あらう	洗う
あらうみ	荒海
あらかべ	荒壁
あらぎょう	荒行
あらごと	荒事
あらそい	争い
あらそう	争う
あらた	新た
あらため	改め
あらて	新手
あらなみ	荒波
あらなわ	荒繩
あらの	荒野
あらまき	新巻
あらもの	荒物
あり	あり
ありあけ	有明
ありさま	有様
ありそ	荒磯
ありゅう	亜流
ある	ある
あるき	歩き
あるく	歩く
あれ	あれ
あれ	荒れ
あれの	荒野
あわ	あわ
あわつぶ	粟粒
あわゆき	淡雪
あわれ	哀れ
あん	あん
あんい	安易
あんいつ	安逸
あんうん	暗雲
あんえい	暗影
あんか	安価
あんか	行火
あんがい	案外
あんかん	安閑
あんき	安危
あんき	暗記
あんぎゃ	行脚
あんきょ	暗渠
あんぐう	行宮
あんくん	暗君
あんけん	案件
あんごう	暗号
あんごう	暗合
あんこく	闇黒
あんさつ	暗殺
あんざん	安産
あんざん	暗算
あんじ	暗示
あんしつ	庵室
あんしつ	暗室
あんじゅう	安住
あんしゅつ	案出
あんしょう	暗礁
あんしょう	暗誦
あんしん	安心
あんせい	安静
あんぜん	安全
あんぜん	暗然
あんそく	安息
あんだ	安打
あんたい	安泰
あんたん	暗澹
あんち	安置
あんちゃく	安着
あんちょく	安直
あんてい	安定
あんてん	暗転
あんど	安堵
あんとう	暗闘
あんどん	行燈
あんない	案内
あんに	暗に
あんねい	安寧
あんのん	安穏
あんばい	按排
あんぴ	安否
あんぶ	鞍部
あんぶん	按分
あんぶん	案文
あんぽう	罨法
あんま	按摩
あんまく	暗幕
あんみん	安眠
あんもく	暗黙
あんや	暗夜
あんやく	暗躍
あんらく	安楽
あんるい	暗涙
いあつ	威圧
いあん	慰安
いい	いい
いいん	委員
いいん	医院
いう	言う
いえ	いえ
いえい	遺影
いえいえ	家々
いえがら	家柄
いえき	胃液
いえじ	家路
いえで	家出
いえぬし	家主
いえもと	家元
いえん	胃炎
いおう	硫黄
いか	いか
いか	以下
いか	医科
いが	いが
いかい	位階
いがい	以外
いがい	意外
いがい	遺骸
いかく	威嚇
いがく	医学
いがぐり	毬栗
いがた	鋳型
いかり	怒り
いかん	偉観
いかん	移管
いかん	衣冠
いかん	遺憾
いき	位記
いき	意気
いき	遺棄
いき	生き
いぎ	威儀
いぎ	意義
いぎ	異議
いきおい	勢い
いきがい	域外
いきどおり	憤り
いきない	域内
いきょう	異境
いきょう	異教
いきょう	異郷
いぎょう	偉業
いぎょう	遺業
いきょく	医局
いく	いく
いく	行く
いくえ	幾重
いくえい	育英
いくじ	育児
いくじゅう	幾十
いくすう	育雛
いくせい	育成
いくせん	幾千
いくた	幾多
いくたび	幾度
いくど	幾度
いくひゃく	幾百
いくびょう	育苗
いくぶん	幾分
いくん	遺勲
いくん	遺訓
いけい	畏敬
いけす	生簀
いけん	意見
いけん	違憲
いげん	威厳
いご	以後
いご	囲碁
いこう	以降
いこう	偉功
いこう	偉効
いこう	威光
いこう	意向
いこう	移行
いこう	憩う
いこく	異国
いこつ	遺骨
いこん	遺恨
いごん	遺言
いざ	いざ
いさい	偉才
いさい	委細
いさい	異彩
いさぎよい	潔い
いざなう	誘う
いさむ	勇む
いさめ	諌め
いさん	胃散
いさん	胃酸
いさん	違算
いさん	遺産
いし	意志
いし	意思
いし	遺志
いし	遺址
いし	医師
いし	縊死
いじ	意地
いじ	維持
いじ	遺児
いしうす	石臼
いしがき	石垣
いしき	意識
いしく	石工
いしだたみ	石畳
いしだん	石段
いしつ	異質
いしつ	遺失
いしばし	石橋
いしぼとけ	石仏
いしゃ	慰謝
いしゃ	医者
いしや	石屋
いしゅ	意趣
いしゅ	異種
いしゅう	異臭
いしゅう	蝟集
いじゅう	移住
いしゅく	畏縮
いしゅく	萎縮
いしゅつ	移出
いじゅつ	医術
いしょ	遺書
いしょう	意匠
いしょう	衣裳
いじょう	以上
いじょう	異常
いじょう	異状
いしょく	委嘱
いしょく	異色
いしょく	移植
いしょく	衣食
いしん	威信
いしん	維新
いじん	偉人
いじん	異人
いす	椅子
いすう	異数
いせい	威勢
いせい	異性
いせき	移籍
いせき	遺跡
いせつ	異説
いぜん	以前
いぜん	依然
いそう	位相
いそうろう	居候
いそぎ	急ぎ
いそぐ	急ぐ
いぞく	遺族
いそべ	磯辺
いそん	依存
いぞん	依存
いぞん	異存
いたい	遺体
いたい	痛い
いだい	偉大
いたく	依託
いたく	委託
いだく	抱く
いだす	出す
いただく	頂く
いたべい	板塀
いたみ	傷み
いたみ	痛み
いたり	至り
いたる	至る
いたん	異端
いち	位置
いちいち	一々
いちいん	一員
いちえん	一円
いちおう	一往
いちぐう	一隅
いちげい	一芸
いちげん	一言
いちご	一期
いちごん	一言
いちざ	一座
いちじ	一事
いちじ	一時
いちじ	一次
いちじつ	一日
いちじゅん	一巡
いちじょう	一定
いちぞく	一族
いちぞん	一存
いちだい	一代
いちだん	一団
いちどう	一同
いちどく	一読
いちに	一二
いちにち	一日
いちにん	一任
いちねん	一念
いちば	市場
いちばん	一番
いちぶ	一部
いちべつ	一別
いちべつ	一瞥
いちぼう	一望
いちまつ	一抹
いちみ	一味
いちめい	一命
いちめん	一面
いちもく	一目
いちやく	一躍
いちゅう	意中
いちょう	移調
いちょう	胃腸
いちよう	一様
いちらん	一覧
いちり	一利
いちり	一理
いちりつ	一律
いちりつ	市立
いちりゅう	一流
いちるい	一塁
いちれん	一連
いちろ	一路
いつ	いつ
いっか	一家
いっかく	一角
いっかつ	一喝
いっかつ	一括
いっかん	一貫
いっき	一揆
いっけ	一家
いっけい	一計
いっけん	一件
いっけん	一見
いっこ	一己
いっこう	一向
いっこう	一考
いっこう	一行
いっこく	一刻
いっさ	一佐
いっさい	一切
いっさく	一昨
いっしき	一式
いっしき	一色
いっしゅ	一種
いっしゅう	一周
いっしゅう	一蹴
いっしゅん	一瞬
いっしょ	一緒
いっしょう	一笑
いっしょう	一生
いっしん	一心
いっしん	一新
いっしん	一身
いっすい	一睡
いっせい	一世
いっせん	一閃
いっそう	一層
いっそう	一掃
いったい	一体
いったい	一帯
いつだつ	逸脱
いったん	一旦
いったん	一端
いっち	一致
いっちょう	一朝
いって	一手
いってい	一定
いってつ	一徹
いってん	一転
いっとう	一等
いっとき	一時
いつに	一に
いっぱ	一派
いっぱん	一半
いっぱん	一般
いっぴつ	一筆
いっぴん	逸品
いっぷく	一服
いっぺん	一変
いっぺん	一片
いっぽう	一方
いつわ	逸話
いで	出で
いてき	夷狄
いてん	移転
いでん	遺伝
いと	いと
いと	意図
いど	緯度
いど	井戸
いどう	異動
いどう	異同
いどう	移動
いどころ	居所
いとしご	愛児
いとなみ	営み
いとなむ	営む
いとまき	糸巻
いな	いな
いない	以内
いなか	田舎
いなさく	稲作
いなずま	稲妻
いなだ	稲田
いなびかり	稲光
いなほ	稲穂
いなむ	否む
いなり	稲荷
いにしえ	古え
いにゅう	移入
いにん	委任
いぬ	いぬ
いね	いね
いのり	祈り
いのる	祈る
いはい	位牌
いはつ	遺髪
いはん	違反
いび	萎靡
いひょう	意表
いびょう	胃病
いひん	遺品
いぶ	慰撫
いふう	威風
いふう	遺風
いふく	衣服
いぶくろ	胃袋
いぶつ	異物
いぶつ	遺物
いへき	胃壁
いへん	異変
いぼ	いぼ
いぼ	異母
いほう	違法
いま	居間
いまさら	今更
いましめ	戒め
いまに	今に
いまや	今や
いまよう	今様
いみ	意味
いみょう	異名
いみん	移民
いむ	医務
いむ	忌む
いめい	異名
いも	いも
いもづる	芋蔓
いもの	鋳物
いもん	慰問
いや	いや
いやおう	否応
いやく	意訳
いやく	違約
いやく	医薬
いやけ	嫌気
いゆう	畏友
いよう	威容
いよう	異様
いよく	意欲
いらい	以来
いらい	依頼
いり	入り
いりえ	入江
いりゅう	慰留
いりょう	衣料
いりょう	医療
いりょく	威力
いる	いる
いる	射る
いる	煎る
いる	鋳る
いる	要る
いる	炒る
いるい	衣類
いれ	入れ
いれい	威令
いれい	慰霊
いれい	異例
いろ	いろ
いろう	慰労
いろう	遺漏
いろか	色香
いろがみ	色紙
いろけ	色気
いろじろ	色白
いろつや	色艶
いろどる	彩る
いろめ	色目
いろん	異論
いわい	祝い
いわう	祝う
いわやま	岩山
いんいん	殷々
いんうつ	陰欝
いんえい	陰影
いんか	引火
いんが	印画
いんが	因果
いんが	陰画
いんかん	印鑑
いんき	陰気
いんぎ	院議
いんきゃく	韻脚
いんきょ	隠居
いんぎょう	印形
いんきょく	陰極
いんぎん	慇懃
いんけん	引見
いんけん	陰険
いんけん	隠見
いんけん	隠顕
いんげん	隠現
いんご	隠語
いんこう	印行
いんこう	咽喉
いんさつ	印刷
いんさん	陰惨
いんし	印紙
いんし	因子
いんし	淫祠
いんじゃ	隠者
いんしゅ	飲酒
いんしゅう	因習
いんじゅん	因循
いんしょう	印章
いんしょう	印象
いんしょく	飲食
いんしん	音信
いんしん	殷賑
いんすう	因数
いんずう	員数
いんせい	院政
いんせい	陰性
いんぜい	印税
いんせき	姻戚
いんせき	引責
いんぜん	隠然
いんそつ	引率
いんたい	引退
いんちょう	院長
いんでん	院殿
いんど	印度
いんとう	淫蕩
いんどう	引導
いんとく	陰徳
いんとく	隠匿
いんに	陰に
いんにん	隠忍
いんねん	因縁
いんび	淫靡
いんぶ	陰部
いんぷ	印譜
いんぶん	韻文
いんぺい	隠蔽
いんぼう	陰謀
いんぽん	淫奔
いんめつ	湮滅
いんよう	引用
いんよう	飲用
いんよう	陰陽
いんりつ	韻律
いんりょう	飲料
いんりょく	引力
いんれい	引例
いんれき	陰暦
いんわい	淫猥
ういじん	初陣
ういまご	初孫
うえした	上下
うえん	迂遠
うえん	有縁
うかい	迂回
うかい	鵜飼
うかがい	伺い
うかがう	窺う
うかがう	伺う
うがん	右岸
うき	雨季
うき	浮き
うきよ	浮世
うく	浮く
うけ	受け
うけたまわる	承る
うけつけ	受付
うげん	右舷
うご	雨後
うごき	動き
うごく	動く
うさん	胡散
うし	うし
うじ	うじ
うじがみ	氏神
うじこ	氏子
うしなう	失う
うしゃ	右社
うしろあし	後足
うしろがみ	後髪
うしろすがた	後姿
うしろだて	後楯
うしろで	後手
うしろはば	後幅
うしろまえ	後前
うしろゆび	後指
うすい	雨水
うすい	薄い
うすかわ	薄皮
うすぎ	薄着
うすくち	薄口
うすぐも	薄雲
うすくれない	薄紅
うすごおり	薄氷
うすじお	薄塩
うすずみ	薄墨
うすちゃ	薄茶
うすで	薄手
うすび	薄日
うすべに	薄紅
うずまき	渦巻
うすみどり	薄緑
うすむらさき	薄紫
うそ	うそ
うだ	右打
うたいこう	謡講
うたう	歌う
うたがい	疑い
うたがう	疑う
うたごえ	歌声
うたごころ	歌心
うたびと	歌人
うたひめ	歌姫
うたまくら	歌枕
うたん	右端
うち	撃ち
うち	射ち
うち	打ち
うち	討ち
うちうみ	内海
うちがわ	内側
うちき	内気
うちきん	内金
うちじに	討死
うちそで	内袖
うちにわ	内庭
うちのり	内法
うちまく	内幕
うちまご	内孫
うちゅう	宇宙
うちわ	内輪
うちわけ	内訳
うつ	撃つ
うつ	射つ
うつ	打つ
うつうつ	欝々
うっけつ	欝血
うつし	写し
うつす	移す
うつす	映す
うつす	写す
うっせき	欝積
うっそう	欝蒼
うったえ	訴え
うって	討手
うっぷん	欝憤
うつぼつ	鬱勃
うつり	移り
うつる	移る
うつる	映る
うつる	写る
うてき	雨滴
うでくび	腕首
うでまえ	腕前
うてん	雨天
うとう	右投
うとく	有徳
うながす	促す
うなばら	海原
うに	うに
うぬ	うぬ
うね	うね
うは	右派
うば	うば
うば	乳母
うばう	奪う
うぶ	うぶ
うぶぎ	産衣
うぶゆ	産湯
うほう	右方
うま	うま
うまいち	馬市
うまかた	馬方
うまみ	旨味
うまや	馬屋
うみ	産み
うみじ	海路
うみべ	海辺
うむ	倦む
うむ	産む
うむ	膿む
うむ	有無
うめ	うめ
うめず	梅酢
うめぼし	梅干
うもう	羽毛
うやまう	敬う
うよく	右翼
うらえり	裏衿
うらおもて	裏表
うらがわ	裏側
うらぐち	裏口
うらさく	裏作
うらじ	裏地
うらて	裏手
うらにわ	裏庭
うらぬの	裏布
うらまち	裏町
うらみ	恨み
うらむ	恨む
うらめ	裏目
うらもん	裏門
うらやま	裏山
うり	うり
うり	売り
うりょう	雨量
うる	得る
うる	売る
うれい	憂い
うろ	うろ
うろ	雨露
うろん	胡乱
うわかわ	上皮
うわがわ	上側
うわき	浮気
うわぎ	上着
うわぐつ	上靴
うわて	上手
うわまえ	上前
うわめ	上目
うわやく	上役
うん	うん
うんえい	運営
うんが	運河
うんかい	雲海
うんきゅう	運休
うんこう	運航
うんこう	運行
うんざん	運算
うんじょう	運上
うんしん	運針
うんすい	雲水
うんせい	運勢
うんそう	運送
うんちく	蘊蓄
うんちん	運賃
うんでい	雲泥
うんてん	運転
うんどう	運動
うんぬん	云々
うんのう	蘊奥
うんぱん	運搬
うんぴつ	運筆
うんめい	運命
うんも	雲母
うんゆ	運輸
うんよう	運用
うんりょう	雲量
えい	エイ
えいい	栄位
えいい	鋭意
えいえい	営々
えいえん	永遠
えいが	映画
えいが	栄華
えいかく	鋭角
えいかん	栄冠
えいき	英気
えいきゅう	永久
えいきょう	影響
えいきょう	英京
えいぎょう	営業
えいけつ	英傑
えいこ	栄枯
えいご	英語
えいこう	曳航
えいこう	栄光
えいこく	英国
えいさい	英才
えいし	英姿
えいじ	嬰児
えいじ	英字
えいしゃ	映写
えいじゅう	永住
えいしょく	栄職
えいしん	栄進
えいじん	英人
えいせい	永世
えいせい	衛星
えいせい	衛生
えいぜん	営繕
えいぞう	営造
えいぞう	映像
えいぞく	永続
えいたい	永代
えいたつ	栄達
えいたん	詠嘆
えいだん	営団
えいだん	英断
えいち	叡知
えいてん	栄転
えいびん	鋭敏
えいぶん	英文
えいべつ	永別
えいほう	鋭鋒
えいまい	英邁
えいみん	永眠
えいやく	英訳
えいゆう	英雄
えいよ	栄誉
えいよう	栄養
えいり	営利
えいり	鋭利
えいれい	英霊
えいわ	英和
ええ	ええ
えがお	笑顔
えきいん	駅員
えきか	液化
えきしゃ	易者
えきしゅ	駅手
えきじょう	液状
えきたい	液体
えきだん	易断
えきちゅう	益虫
えきちょう	益鳥
えきちょう	駅長
えきとう	駅頭
えきびょう	疫病
えきべん	駅弁
えきまえ	駅前
えきむ	役務
えきり	疫痢
えこう	回向
えごころ	絵心
えし	絵師
えしき	会式
えじき	餌食
えしゃく	会釈
えしん	会心
えず	絵図
えすがた	絵姿
えぞ	蝦夷
えぞう	画像
えたい	得体
えだは	枝葉
えだまめ	枝豆
えっきょう	越境
えっけん	謁見
えっけん	越権
えっとう	越冬
えつどく	閲読
えつねん	越年
えっぺい	閲兵
えつらく	悦楽
えつらん	閲覧
えつれき	閲歴
えて	得手
えど	江戸
えとく	会得
えな	えな
えび	えび
えふで	絵筆
えほん	絵本
えみ	えみ
えむ	笑む
えもの	獲物
えもの	得物
えらい	偉い
えらがた	偉方
えらぶ	選ぶ
えらぶつ	偉物
えりさき	衿先
えりしょう	襟章
えりはば	衿幅
えりまき	衿巻
える	える
える	選る
える	彫る
える	得る
えるぴい	ＬＰ
えんいん	延引
えんいん	遠因
えんえい	遠泳
えんえき	演繹
えんえん	炎々
えんか	円貨
えんか	塩化
えんか	嚥下
えんかい	宴会
えんかい	沿海
えんかい	遠海
えんがい	煙害
えんかく	沿革
えんかく	遠隔
えんかつ	円滑
えんがわ	縁側
えんがん	沿岸
えんき	延期
えんき	遠忌
えんぎ	演技
えんぎ	縁起
えんきょく	婉曲
えんきん	遠近
えんぐん	厭軍
えんぐん	援軍
えんけい	円形
えんけい	遠景
えんげい	園芸
えんげい	演芸
えんげき	演劇
えんこ	円弧
えんこ	縁故
えんご	掩護
えんご	援護
えんご	縁語
えんごく	遠国
えんこん	怨恨
えんさ	怨嗟
えんざい	寃罪
えんさき	縁先
えんさん	塩酸
えんざん	遠山
えんし	遠視
えんじ	臙脂
えんじゃ	演者
えんじゃ	縁者
えんしゅう	円周
えんしゅう	演習
えんじゅく	円熟
えんしゅつ	演出
えんしょ	炎暑
えんじょ	援助
えんしょう	延焼
えんじょう	炎上
えんしん	遠心
えんすい	円錐
えんすい	塩水
えんせい	厭世
えんせい	遠征
えんせき	宴席
えんぜつ	演説
えんせん	厭戦
えんせん	沿線
えんそ	塩素
えんそう	演奏
えんそく	遠足
えんたい	延滞
えんだい	演台
えんだい	演題
えんだい	縁台
えんだい	遠大
えんたく	円卓
えんだん	演壇
えんだん	縁談
えんちゃく	延着
えんちゅう	円柱
えんちょう	園長
えんちょう	延長
えんてい	園丁
えんてん	炎天
えんでん	塩田
えんとう	円〓
えんとう	円筒
えんとう	遠島
えんどう	沿道
えんとつ	煙突
えんにち	縁日
えんねつ	炎熱
えんばん	円盤
えんぴつ	鉛筆
えんぶん	塩分
えんぺい	掩蔽
えんぺい	援兵
えんぼう	遠望
えんぽう	遠方
えんま	閻魔
えんまく	煙幕
えんまん	円満
えんめい	延命
えんよう	援用
えんよう	遠洋
えんらい	遠来
えんりょ	遠慮
えんるい	塩類
えんれい	艶麗
えんろ	遠路
おあい	汚穢
おい	おい
おい	老い
おいわけ	追分
おう	おう
おう	追う
おう	負う
おうい	王位
おういつ	横溢
おうう	奥羽
おうえん	応援
おうおう	往々
おうか	桜花
おうか	謳歌
おうが	横臥
おうかん	王冠
おうぎ	奥義
おうきゅう	応急
おうきゅう	王宮
おうこ	往古
おうこう	横行
おうこう	王侯
おうこく	王国
おうごん	黄金
おうざ	王座
おうさま	王様
おうし	横死
おうじ	往時
おうじ	王子
おうしつ	王室
おうじゃ	王者
おうしゅう	奥州
おうしゅう	応酬
おうしゅう	欧州
おうじょ	王女
おうしょう	応召
おうじょう	往生
おうしょく	黄色
おうしん	往診
おうせ	逢瀬
おうせい	旺盛
おうせい	王政
おうせつ	応接
おうせん	応戦
おうぞく	王族
おうだ	殴打
おうたい	応待
おうたい	横隊
おうだく	応諾
おうだん	横断
おうちゃく	横着
おうちょう	王朝
おうて	王手
おうてん	横転
おうと	嘔吐
おうとう	応答
おうどう	王道
おうどう	黄道
おうとつ	凹凸
おうねん	往年
おうはん	凹版
おうひ	王妃
おうふく	往復
おうぶん	応分
おうぶん	欧文
おうへい	横柄
おうべい	欧米
おうぼ	応募
おうほう	応報
おうぼう	横暴
おうよう	応用
おうらい	往来
おうりょう	横領
おうろ	往路
おえつ	鳴咽
おお	おお
おおあじ	大味
おおあな	大穴
おおあめ	大雨
おおい	多い
おおい	被い
おおう	被う
おおおとこ	大男
おおかぜ	大風
おおがた	大型
おおがら	大柄
おおかわ	大川
おおきみ	大君
おおく	多く
おおぐち	大口
おおくら	大蔵
おおごえ	大声
おおしお	大潮
おおせ	仰せ
おおぜい	多勢
おおぜき	大関
おおぞら	大空
おおだい	大台
おおて	大手
おおで	大手
おおなみ	大波
おおばし	大橋
おおはば	大幅
おおばん	大判
おおまた	大股
おおみず	大水
おおむかし	大昔
おおめ	大目
おおもの	大物
おおや	大家
おおゆき	大雪
おおよう	鷹揚
おおわらわ	大童
おかあさま	かあ
おかす	侵す
おかす	犯す
おかす	冒す
おかぶ	お株
おがむ	拝む
おかめ	岡目
おがわ	小川
おかん	悪寒
おき	おき
おきあい	沖合
おきて	掟て
おぎない	補い
おぎなう	補う
おきなわ	沖縄
おく	於く
おく	置く
おくがい	屋外
おくがき	奥書
おくがた	奥方
おくぎ	奥義
おくさま	奥様
おくさん	奥様
おくじょう	屋上
おくそく	臆測
おくそこ	奥底
おくち	奥地
おくて	奥手
おくない	屋内
おくば	奥歯
おくびょう	臆病
おくまん	億万
おくやま	奥山
おくり	送り
おくる	送る
おくる	贈る
おくれ	遅れ
おこす	興す
おこたり	怠り
おこたる	怠る
おこる	興る
おごる	奢る
おさ	おさ
おさない	幼い
おさめ	納め
おし	押し
おじ	おじ
おしえ	教え
おしょう	和尚
おしょく	汚職
おじょく	汚辱
おす	押す
おす	推す
おすい	汚水
おせん	汚染
おそい	遅い
おそう	襲う
おそれ	恐れ
おそれ	虞れ
おそん	汚損
おち	落ち
おちうど	落人
おちかた	遠方
おちゅうど	落人
おつ	おつ
おっくう	億劫
おっけん	越権
おって	追手
おつねん	越年
おてん	汚点
おとうさま	とう
おとぎ	お伽
おとこぎ	男気
おどし	威し
おとずれ	訪れ
おとめ	少女
おとり	劣り
おどり	踊り
おとる	劣る
おどる	踊る
おとろえ	衰え
おどろき	驚き
おどろく	驚く
おなじ	同じ
おにがみ	鬼神
おにばば	鬼婆
おにび	鬼火
おね	尾根
おば	おば
おはち	お鉢
おばな	雄花
おびふう	帯封
おぶつ	汚物
おぶね	小舟
おぼえ	覚え
おまえ	お前
おめい	汚名
おめし	御召
おもい	思い
おもい	重い
おもう	思う
おもかげ	面影
おもさ	重さ
おもし	重し
おもてうら	表裏
おもてえり	表衿
おもてがわ	表側
おもてぐち	表口
おもてげい	表芸
おもてぬの	表布
おもと	お許
おもなが	面長
おもに	重荷
おもみ	重み
おもむき	趣き
おもや	母家
おもゆ	重湯
おもり	重り
おや	おや
おやかた	親方
おやぐさ	親草
おやこ	親子
おやごころ	親心
おやしお	親潮
おやだま	親玉
おやぶん	親分
おやま	女形
おやゆび	親指
およぎ	泳ぎ
およぐ	泳ぐ
およぶ	及ぶ
おり	折り
おりおり	折々
おりがら	折柄
おりふし	折節
おりもの	織物
おる	おる
おる	織る
おる	折る
おれ	おれ
おろがむ	拝む
おろし	卸し
おろす	卸す
おわい	汚穢
おん	おん
おんあい	恩愛
おんい	恩威
おんいん	音韻
おんかい	音階
おんがく	音楽
おんかん	音感
おんがん	温顔
おんき	遠忌
おんぎ	恩義
おんきゅう	恩給
おんきょう	音響
おんぎょく	音曲
おんくん	音訓
おんけい	恩恵
おんけつ	温血
おんけん	穏健
おんこ	恩顧
おんこう	温厚
おんさ	音叉
おんし	恩師
おんし	恩賜
おんしつ	温室
おんしゃ	恩赦
おんじゅ	飲酒
おんしゅう	恩讎
おんしゅう	温習
おんじゅん	温順
おんしょう	恩賞
おんしょう	温床
おんじょう	恩情
おんしょく	音色
おんしん	音信
おんじん	恩人
おんせい	音声
おんせつ	音節
おんせん	温泉
おんそ	音素
おんそく	音速
おんぞん	温存
おんたい	温帯
おんだん	温暖
おんちゅう	御中
おんちょう	恩寵
おんちょう	音調
おんてい	音程
おんてき	怨敵
おんてん	恩典
おんど	温度
おんど	音頭
おんとう	穏当
おんどく	音読
おんな	女−
おんなで	女手
おんぱ	音波
おんばん	音盤
おんびん	穏便
おんびん	音便
おんぷ	音符
おんぷ	音譜
おんみ	御身
おんやく	音訳
おんよう	温容
おんりつ	音律
おんりょう	怨霊
おんりょう	温良
おんりょう	音量
おんわ	温和
お国	お国
かい	かい
かい	下位
かい	飼い
かい	買い
がい	我意
かいあく	改悪
がいあく	害悪
がいあつ	外圧
かいい	怪異
かいいん	会員
かいいん	海員
かいうん	海運
かいうん	開運
かいえん	開演
がいえん	外延
かいか	怪火
かいか	開化
かいか	開花
かいか	階下
かいが	絵画
がいか	凱歌
がいか	外貨
かいかい	開会
かいがい	海外
がいかい	外海
がいかい	外界
かいかく	改革
がいかく	外角
がいかく	外郭
かいかつ	快活
がいかつ	概括
かいがら	貝殻
かいかん	会館
かいかん	快感
かいかん	快漢
かいかん	怪漢
かいがん	海岸
かいがん	開眼
がいかん	外観
がいかん	概観
かいき	会期
かいき	回忌
かいき	回帰
かいき	快気
かいき	怪奇
かいぎ	会議
かいぎ	懐疑
がいき	外気
かいぎゃく	諧謔
かいきゅう	懐旧
かいきゅう	階級
かいきょ	快挙
かいきょう	回教
かいきょう	懐郷
かいきょう	海峡
かいぎょう	開業
がいきょう	概況
かいきん	解禁
かいきん	皆勤
かいきん	開衿
がいきん	外勤
かいぐん	海軍
かいけい	会計
がいけい	外形
かいけつ	解決
かいけつ	快傑
かいけん	会見
かいけん	懐剣
かいけん	開顕
かいげん	改元
かいげん	開眼
がいけん	外見
かいこ	解雇
かいこ	回顧
かいこ	懐古
かいご	改悟
がいご	外語
かいこう	回航
かいこう	開口
かいこう	開校
かいこう	開港
かいこう	開講
かいこう	邂逅
かいごう	会合
がいこう	外交
がいこう	外向
かいこく	戒告
かいこく	海国
かいこく	開国
がいこく	外国
がいこつ	骸骨
かいこん	悔恨
かいこん	開墾
かいさ	海佐
かいさい	開催
がいさい	外債
かいさく	改作
かいさく	開鑿
かいさつ	改札
かいさん	解散
かいざん	改竄
がいさん	概算
かいし	開始
かいじ	海事
がいし	外紙
がいし	外資
がいし	碍子
かいしゃ	会社
かいしゃく	解釈
かいしゅう	会衆
かいしゅう	回収
かいしゅう	改宗
かいしゅう	改修
かいじゅう	懐柔
かいじゅう	晦渋
がいしゅつ	外出
かいしゅん	回春
かいしゅん	改悛
かいしょ	楷書
かいじょ	解除
かいしょう	解消
かいしょう	快勝
かいしょう	改称
かいじょう	会場
かいじょう	海上
かいじょう	開場
かいじょう	階上
かいじょう	階乗
がいしょう	外傷
がいしょう	外相
がいしょう	街娼
かいしょく	会食
かいしょく	解職
がいしょく	外食
かいしん	会心
かいしん	回診
かいしん	改心
かいしん	改新
かいしん	改進
かいじん	灰燼
がいしん	外心
がいじん	外人
かいず	海図
かいすい	海水
かいすう	回数
がいすう	概数
かいせい	回生
かいせい	快晴
かいせい	改姓
かいせい	改正
かいせき	解析
かいせつ	解説
かいせつ	開設
がいせつ	概説
かいせん	会戦
かいせん	回船
かいせん	改選
かいせん	開戦
かいぜん	改善
がいせん	凱旋
がいせん	外線
かいそ	改組
かいそ	開祖
かいそう	会葬
かいそう	回想
かいそう	回漕
かいそう	回送
かいそう	快走
かいそう	改装
かいそう	海草
かいそう	階層
かいぞう	改造
がいそう	外装
かいぞえ	介添
かいそく	会則
かいそく	快速
かいぞく	海賊
がいそん	外孫
かいだ	快打
かいたい	解体
かいたい	拐帯
かいだい	解題
かいだい	改題
かいだい	海内
かいたく	開拓
かいだく	快諾
かいたん	塊炭
かいだん	会談
かいだん	怪談
かいだん	階段
がいたん	慨嘆
がいち	外地
かいちく	改築
かいちゅう	懐中
かいちゅう	改鋳
かいちゅう	海中
がいちゅう	害虫
かいちょう	会長
かいちょう	快調
かいちょう	開帳
かいちょう	諧調
がいちょう	害鳥
かいちょく	戒飭
かいちん	開陳
かいつう	開通
かいづか	貝塚
かいてい	改定
かいてい	改訂
かいてい	海底
かいてい	開廷
かいてき	快適
がいてき	外敵
かいてん	回天
かいてん	回転
かいてん	開店
がいでん	外電
かいとう	会頭
かいとう	解答
かいとう	回答
かいどう	会同
かいどう	会堂
かいどう	海道
かいどう	街道
がいとう	外套
がいとう	街燈
がいとう	街頭
がいとう	該当
かいどく	解読
かいどく	回読
がいどく	害毒
かいなん	海難
かいにゅう	介入
かいにん	解任
かいにん	懐妊
がいねん	概念
がいはく	外泊
がいはく	該博
かいばしら	貝柱
かいはつ	開発
かいばつ	海抜
かいはん	改版
かいひ	会費
かいひ	回避
かいびゃく	開闢
かいひょう	解氷
かいひょう	開票
がいひょう	概評
かいひん	海浜
がいぶ	外部
かいふう	海風
かいふう	開封
かいふく	回復
かいぶつ	怪物
かいぶん	怪聞
がいぶん	外聞
かいへい	海兵
かいへい	開平
かいへい	開閉
かいへん	改変
かいへん	海辺
かいほう	介抱
かいほう	会報
かいほう	解放
かいほう	快報
かいほう	快方
かいほう	開放
かいほう	開法
かいぼう	解剖
かいぼう	海防
がいぼう	外貌
がいまい	外米
かいまく	開幕
かいみょう	戒名
かいむ	皆無
がいむ	外務
かいめい	解明
かいめい	改名
かいめつ	壊滅
かいめん	海面
がいめん	外面
かいもく	皆目
がいや	外野
かいやく	解約
かいゆ	快癒
かいゆう	回遊
がいゆう	外遊
かいよう	海洋
がいよう	外用
がいよう	概要
かいらい	傀儡
がいらい	外来
かいらく	快楽
かいらん	解纜
かいらん	回覧
かいらん	壊乱
かいり	海里
かいりき	怪力
かいりく	海陸
かいりつ	戒律
がいりゃく	概略
かいりゅう	海流
かいりょう	改良
かいりょく	怪力
がいりん	外輪
かいれい	回礼
かいろ	回路
かいろ	懐炉
かいろ	海路
がいろ	街路
かいろう	回廊
がいろん	概論
かいわ	会話
かいわい	界隈
かいん	下院
かう	かう
かう	飼う
かう	買う
かうん	家運
かえ	替え
かえし	返し
かえす	帰す
かえす	返す
かえり	帰り
かえる	帰る
かえる	返る
かえん	火焔
かおいろ	顔色
かおく	家屋
かおやく	顔役
がか	画家
がか	画架
かがい	加害
かがい	花街
かがい	課外
がかい	瓦解
かかえ	抱え
かかく	価格
かかく	家格
かがく	化学
かがく	価額
かがく	科学
ががく	雅楽
かがみもち	鏡餅
かがやき	輝き
かがやく	輝く
かかり	係り
かかりいん	係員
かかりちょう	係長
かかる	罹る
かかん	果敢
かき	かき
かき	夏期
かき	夏季
かき	火器
かき	火気
かき	花器
かき	書き
かき	掻き
がき	餓鬼
かぎあな	鍵穴
かきとめ	書留
かきね	垣根
かきゅう	下級
かきゅう	加給
かきゅう	火急
かきょう	佳境
かきょう	家郷
かきょう	架橋
かきょう	華僑
かぎょう	家業
かぎょう	稼業
かぎょう	課業
かきょく	歌曲
かぎり	限り
かぎる	限る
かきん	家禽
かきん	瑕瑾
かく	かく
かく	佳句
かく	欠く
かく	書く
かく	掻く
かぐ	家具
かぐ	嗅ぐ
かくい	各位
かくい	隔意
がくい	学位
かくいん	各員
かくいん	閣員
がくいん	学院
かくう	架空
かぐう	仮寓
がくえん	学園
がくおん	楽音
かくぎ	閣議
がくぎょう	学業
がくげい	学芸
がくげき	楽劇
かくげつ	隔月
かくげん	格言
かくげん	確言
かくご	覚悟
かくさ	格差
かくさ	較差
かくざ	擱坐
がくさい	学才
かくさく	画策
かくし	客死
かくじ	各自
がくし	学士
がくし	学資
がくし	楽師
がくじ	学事
かくしき	格式
がくしき	学識
かくしつ	確執
かくじつ	確実
かくじつ	隔日
かくしゃ	各社
がくしゃ	学者
かくしゅ	各種
かくしゅ	馘首
かくしゅう	隔週
かくじゅう	拡充
がくしゅう	学習
がくじゅつ	学術
かくしょ	各所
かくしょう	各省
かくしょう	確証
がくしょう	楽章
かくしん	核心
かくしん	確信
かくしん	革新
かくじん	各人
かくす	隠す
かくせい	廓清
かくせい	覚醒
かくせい	隔世
がくせい	学制
がくせい	学生
がくせい	楽聖
がくせき	学籍
がくせつ	学説
かくぜん	画然
がくぜん	愕然
がくそう	学僧
がくそう	学窓
がくそく	学則
かくたい	客体
かくだい	拡大
がくたい	楽隊
かくたん	喀痰
かくだん	格段
がくだん	楽団
がくだん	楽壇
かくち	各地
かくちょう	拡張
がくちょう	学長
がくちょう	楽長
かくてい	確定
がくてん	楽典
かくど	角度
がくと	学徒
かくとう	格闘
かくとう	確答
がくとう	学統
がくどう	学童
かくとく	獲得
がくない	学内
かくにん	確認
かくねん	隔年
がくねん	学年
かくは	各派
がくは	学派
がくばつ	学閥
かくはん	撹拌
がくひ	学費
かくひつ	擱筆
かくぶ	各部
がくふ	岳父
がくふ	楽譜
がくぶ	学部
がくふう	学風
がくぶち	額縁
かくへき	隔壁
かくべつ	格別
かくほ	確保
かくほう	確報
かくぼう	角帽
がくぼう	学帽
かくめい	革命
がくめい	学名
がくめん	額面
がくもん	学問
がくや	楽屋
かくやく	確約
かくやす	格安
がくゆう	学友
かぐら	神楽
かくらん	撹乱
かくり	隔離
がくり	学理
かくりつ	確率
かくりつ	確立
かくりょう	閣僚
がくりょく	学力
がくれい	学齢
がくれき	学歴
かくろん	各論
かくん	家訓
かけ	かけ
かけ	掛け
かけ	欠け
がけ	がけ
かけい	家系
かけい	家計
かげえ	影絵
かけおち	駆落
かけおち	駈落
かげき	歌劇
かげき	過激
かけきん	掛金
かげぐち	陰口
かげぜん	陰膳
かけつ	可決
かげつ	箇月
かけん	家憲
かげん	下弦
かげん	加減
かげん	過言
かこ	過去
かご	加護
かご	歌語
かご	過誤
がご	雅語
かこい	囲い
かこう	囲う
かこう	下降
かこう	加工
かこう	河口
かこう	火口
かごう	化合
がこう	画工
がごう	雅号
かこく	箇国
かこく	苛酷
かこく	過酷
かこみ	囲み
かこむ	囲む
かこん	禍根
かごん	過言
かさ	かさ
かさい	家裁
かさい	火災
かざい	家財
かざかみ	風上
かさく	佳作
かさく	家作
かざぐすり	風薬
かざぐるま	風車
かざしも	風下
かざみ	風見
かざり	飾り
かざる	飾る
かさん	加算
かさん	家産
かざん	火山
かし	かし
かし	下士
かし	下賜
かし	仮死
かし	歌詞
かし	河岸
かし	菓子
かし	貸し
かじ	加持
かじ	家事
かじ	火事
がし	餓死
かしぐ	炊ぐ
かしこい	賢い
かしつ	過失
かじつ	果実
かじつ	過日
がしつ	画室
かしほん	貸本
かしま	貸間
かしゃ	貨車
かしゃく	呵責
かしゅ	歌手
かじゅ	果樹
かしゅう	歌集
かじゅう	加重
かじゅう	果汁
かじゅう	荷重
かじゅう	過重
がしゅう	我執
かじゅく	家塾
がじゅく	画塾
かしょ	箇所
かしょ	個所
かしょう	仮称
かしょう	河床
かしょう	過小
かじょう	箇条
かじょう	過剰
がしょう	画商
がしょう	賀正
がじょう	牙城
がじょう	賀状
かしわもち	柏餅
かしん	過信
かじん	佳人
かじん	家人
かじん	歌人
かす	貸す
がす	ガス
かすい	仮睡
かすい	河水
かずかず	数々
かすむ	霞む
かぜ	かぜ
かせい	化成
かせい	加勢
かせい	家政
かせい	歌聖
かせい	火勢
かせい	火星
かせい	和声
かぜい	課税
がせい	賀正
かせき	化石
かせぎ	稼ぎ
かせつ	仮説
かせつ	架設
かせん	化繊
かせん	架線
かせん	河川
がぜん	俄然
かそう	下層
かそう	仮想
かそう	仮装
かそう	家相
かそう	火葬
がぞう	画像
かそく	加速
かぞく	家族
かぞく	華族
かた	かた
かた	過多
かたあし	片足
かたい	堅い
かだい	課題
かだい	過大
かたうで	片腕
かたおや	片親
かたがた	方々
かたがみ	型紙
かたがわ	片側
かたぎ	堅気
かたきうち	敵討
かたぐるま	肩車
かたさ	硬さ
かたさき	肩先
かたず	固唾
かたすみ	片隅
かたずみ	堅炭
かたせん	肩線
かたて	片手
かたはし	片端
かたはば	肩幅
かたひざ	片膝
かたほう	片方
かたぼう	片棒
かたみ	形見
かたみ	肩身
かたみち	片道
かたむき	傾き
かたむく	傾く
かため	固め
かため	片眼
かためん	片面
かたやま	肩山
かたり	語り
かたる	語る
かたん	荷担
かだん	下段
かだん	果断
かだん	歌壇
かだん	花壇
かち	かち
かち	価値
かち	勝ち
かちく	家畜
かちゅう	渦中
かちゅう	家中
かちゅう	火中
かちょう	家長
かちょう	花鳥
かちょう	課長
かつ	かつ
かつ	勝つ
かつあい	割愛
かつおぶし	鰹節
かっか	閣下
がっか	学科
がっか	学課
がっかい	学会
がっかい	学界
かっかん	客観
かっき	画期
かっき	活気
かっき	客気
がっき	学期
がっき	楽器
がっきゅう	学究
がっきゅう	学級
かっきょ	割拠
かっきょう	活況
がっきょく	楽曲
がっく	学区
かっくう	滑空
かっけ	脚気
かつげき	活劇
かっけつ	喀血
かっこ	各個
かっこ	確乎
かっこ	確個
かっこ	括孤
かっこう	滑降
がっこう	学校
かっこく	各国
かっさい	喝采
がっさく	合作
かっさつ	活殺
かつじ	活字
かっしゃ	滑車
がっしゅく	合宿
かつじょう	割譲
がっしょう	合唱
がっしょう	合掌
かっしょく	褐色
かっすい	渇水
かっせん	合戦
かっそう	滑走
がっそう	合奏
がったい	合体
かったつ	豁達
がっち	合致
かっちゅう	甲冑
かって	勝手
がってん	合点
かっとう	葛藤
かつどう	活動
かっぱ	喝破
かっぱ	合羽
かっぱつ	活発
かっぱん	活版
がっぴ	月日
がっぴょう	合評
がっぺい	合併
かっぽ	濶歩
かっぽう	割烹
かつぼう	渇望
がっぽん	合本
かつもく	刮目
かつやく	活躍
かつよう	活用
かつりょく	活力
かつろ	活路
かて	かて
かてい	仮定
かてい	家庭
かてい	河底
かてい	課程
かてい	過程
かでん	家伝
がてん	合点
かと	過渡
かど	かど
かど	過度
かとう	下等
かどう	可動
かどう	歌道
かどう	稼動
かどう	華道
かとく	家督
かどぐち	門口
かどで	門出
かどまつ	門松
かな	かな
かなあみ	金網
かない	家内
かなぐ	金具
かなづち	金槌
かなぼう	金棒
かなもの	金物
かなやま	金山
かならず	必ず
かに	かに
かにち	箇日
かにゅう	加入
かね	かね
かねぐら	金蔵
かねじゃく	曲尺
かねだか	金高
かねつ	加熱
かねめ	金目
かねん	箇年
かの	かの
かのう	化膿
かのう	可能
かのう	嘉納
かのじょ	彼女
かば	かば
かはい	加配
かばいろ	樺色
がはく	画伯
かはん	河畔
かはん	過半
かはん	過般
かひ	可否
かび	かび
かび	華美
かひつ	加筆
かびん	過敏
かふ	下付
かふ	寡婦
かふ	火夫
かぶ	かぶ
かぶ	下部
かぶ	歌舞
かふう	家風
がふう	画風
かぶか	株価
かふく	禍福
かぶけん	株券
かぶしき	株式
かぶぬし	株主
かぶや	株屋
かふん	花粉
かぶん	寡聞
かぶん	過分
かへい	寡兵
かへい	貨幣
かべがみ	壁紙
かへん	可変
かべん	花弁
かほう	下方
かほう	加法
かほう	家宝
かほう	果報
がほう	画報
かま	かま
がま	がま
かまえ	構え
がまん	我慢
かみ	加味
かみあぶら	髪油
かみかぜ	神風
かみがた	上方
かみき	上期
かみくず	紙屑
かみざ	上座
かみだな	神棚
かみて	上手
かみぶくろ	紙袋
かみほとけ	神仏
かみや	紙屋
かみよ	神代
かみわざ	神業
かみん	仮眠
かむ	〓む
かむ	かむ
かめ	かめ
かめい	仮名
かめい	加盟
かめい	家名
かめん	仮面
がめん	画面
かも	かも
かもい	鴨居
かもく	寡黙
かもく	科目
かもつ	貨物
かもりょう	鴨猟
かもん	家紋
かもん	家門
かや	かや
かや	蚊帳
かやく	加薬
かやく	火薬
かやく	課役
かよい	通い
かよう	歌謡
かよう	火曜
かよう	通う
かよく	寡欲
がよく	我欲
からい	辛い
からかさ	唐傘
からかみ	唐紙
からくさ	唐草
からくち	辛口
からぐるま	空車
からくれない	唐紅
からすぐち	烏口
からて	唐手
からとう	辛党
からみ	辛味
からみ	搦み
からよう	唐様
がらん	伽藍
かり	かり
かり	仮り
かり	加里
かり	借り
かり	狩り
かりいと	仮糸
かりうど	狩人
かりに	仮に
かりね	仮寝
かりばし	仮橋
かりゅう	下流
かりゅう	河流
がりゅう	我流
かりょう	下僚
かりょう	科料
がりょう	雅量
かりょく	火力
かる	刈る
かる	駆る
かる	借る
かるい	軽い
かるいし	軽石
かるがる	軽々
かるくち	軽口
かるわざ	軽業
かれい	嘉例
かれい	華麗
がれき	瓦礫
かれつ	苛烈
かれら	彼ら
かれん	可憐
かろう	家老
かろう	過労
がろう	画廊
がわ	がわ
かわうお	川魚
かわおび	革帯
かわかぜ	川風
かわかみ	川上
かわき	渇き
かわぎし	川岸
かわく	渇く
かわく	乾く
かわぐち	川口
かわぐつ	革靴
かわざかな	川魚
かわしも	川下
かわじり	川尻
かわすじ	川筋
かわせ	為替
かわぞこ	川底
かわど	革砥
かわばた	川端
かわはば	川幅
かわべ	川辺
かわら	河原
がん	がん
かんあん	勘案
かんい	冠位
かんい	官位
かんい	簡易
かんいん	姦淫
かんいん	官員
かんえい	官営
がんえん	岩塩
かんおう	感応
かんおう	観桜
かんおん	漢音
かんか	干戈
かんか	患家
かんか	感化
かんか	看過
かんか	管下
かんか	閑暇
がんか	眼下
がんか	眼科
かんかい	官海
かんかい	官界
かんがい	干害
かんがい	感慨
かんがい	潅漑
かんがい	旱害
がんかい	眼界
かんがえ	考え
かんかく	感覚
かんかく	間隔
かんがく	官学
かんがく	漢学
かんがく	管楽
かんかつ	管轄
かんがん	汗顔
かんき	乾季
かんき	寒気
かんき	勘気
かんき	喚起
かんき	官紀
かんき	換気
かんき	歓喜
かんぎく	観菊
かんきつ	柑橘
かんきゃく	観客
かんきゃく	閑却
かんきゅう	感泣
かんきゅう	緩急
がんきゅう	眼球
かんきょ	閑居
かんきょう	感興
かんきょう	環境
がんきょう	眼鏡
がんきょう	頑強
かんきん	換金
かんきん	監禁
がんきん	元金
かんく	管区
がんぐ	玩具
がんくつ	岩窟
がんくび	雁首
かんぐん	官軍
かんけい	関係
かんけい	奸計
かんげい	歓迎
かんげき	感激
かんげき	観劇
かんげき	間隙
かんけつ	完結
かんけつ	簡潔
かんけん	官憲
かんけん	管見
かんげん	換言
かんげん	甘言
かんげん	管絃
かんげん	諌言
かんげん	還元
がんけん	頑健
かんこ	喚呼
かんご	漢語
かんご	看護
がんこ	頑固
かんこう	刊行
かんこう	勘考
かんこう	感光
かんこう	慣行
かんこう	敢行
かんこう	緩行
かんこう	観光
がんこう	眼光
かんごえ	寒肥
かんこく	寒国
かんこく	勧告
かんこく	韓国
かんごく	監獄
かんさ	監査
かんさい	関西
かんさく	間作
かんさく	奸策
かんさつ	監察
かんさつ	観察
かんさつ	鑑札
かんさん	換算
かんさん	閑散
かんし	干支
かんし	漢詩
かんし	監視
かんし	看視
かんし	諌止
かんじ	幹事
かんじ	感じ
かんじ	漢字
かんじ	莞爾
かんしき	鑑識
がんしき	眼識
かんしつ	乾湿
がんじつ	元日
かんしゃ	官舎
かんしゃ	感謝
かんじゃ	患者
かんしゃく	癇癪
かんじゃく	閑寂
かんしゅ	看取
かんしゅ	看守
かんじゅ	感受
かんじゅ	甘受
かんじゅ	貫首
かんしゅう	慣習
かんしゅう	監修
かんしゅう	観衆
かんしょ	寒暑
かんじょ	官女
がんしょ	願書
かんしょう	勧奨
かんしょう	干渉
かんしょう	感傷
かんしょう	管掌
かんしょう	簡捷
かんしょう	緩衝
かんしょう	観照
かんしょう	観賞
かんしょう	鑑賞
かんじょう	勘定
かんじょう	勧請
かんじょう	感情
かんじょう	感状
かんじょう	環状
がんじょう	頑丈
かんしょく	寒色
かんしょく	官職
かんしょく	感触
かんしょく	間色
かんしょく	間食
かんしょく	閑職
がんしょく	顔色
かんしん	寒心
かんしん	感心
かんしん	関心
かんしん	奸臣
かんじん	寛仁
かんじん	肝腎
かんじん	閑人
かんすい	冠水
かんすい	完遂
かんすい	潅水
かんすう	函数
かんせい	喚声
かんせい	完成
かんせい	官制
かんせい	官製
かんせい	感性
かんせい	慣性
かんせい	管制
かんせい	閑静
かんせい	陥穽
かんぜい	関税
かんせき	漢籍
がんせき	岩石
かんせつ	間接
かんせつ	関節
かんぜつ	冠絶
かんせん	官選
かんせん	幹線
かんせん	感染
かんせん	観戦
かんぜん	完全
かんぜん	敢然
がんぜん	眼前
かんそ	簡素
がんそ	元祖
かんそう	乾燥
かんそう	乾草
かんそう	感想
かんそう	歓送
かんぞう	肝臓
がんそう	含嗽
がんぞう	贋造
かんそく	観測
かんそん	寒村
かんたい	寒帯
かんたい	款待
かんたい	艦隊
かんだい	寛大
がんたい	眼帯
かんたく	干拓
かんたん	感嘆
かんたん	簡単
かんたん	肝胆
かんだん	寒暖
かんだん	間断
がんたん	元旦
かんち	感知
かんち	関知
かんち	奸知
がんちく	含蓄
かんちゅう	寒中
がんちゅう	眼中
かんちょぅ	間牒
かんちょう	官庁
かんちょう	干潮
かんちょう	管長
かんちょう	艦長
かんちょう	館長
かんちょう	浣腸
かんつう	姦通
かんつう	貫通
かんてい	官邸
かんてい	艦艇
かんてい	鑑定
かんてつ	貫徹
かんてん	寒天
かんてん	観点
かんでん	感電
かんど	感度
かんとう	巻頭
かんとう	官等
かんとう	敢闘
かんとう	関東
かんどう	勘当
かんどう	感動
かんどう	間道
かんとく	感得
かんとく	監督
かんない	管内
かんなん	艱難
かんにん	堪忍
かんぬし	神主
かんねん	観念
がんねん	元年
かんのう	堪能
かんのう	完納
かんのう	官能
かんのう	感応
かんのん	観音
かんぱ	寒波
かんぱ	看破
かんぱい	乾杯
かんぱい	完敗
かんばつ	間伐
かんばつ	旱魃
かんぱつ	渙発
かんばん	看板
かんぱん	乾板
かんぱん	干犯
かんぱん	甲板
かんび	完備
かんび	甘美
かんぴ	官費
かんびょう	看病
がんびょう	眼病
かんぶ	幹部
かんぶ	患部
かんぷ	還付
かんぷう	寒風
かんぷう	完封
かんぷく	感服
かんぶつ	乾物
かんぶん	漢文
かんぷん	感奮
かんぺき	完璧
かんぺき	癇癖
がんぺき	岸壁
かんべつ	鑑別
かんべん	勘弁
かんべん	簡便
かんぺん	官辺
かんぼう	官房
かんぼう	感冒
かんぼう	観望
かんぽう	官報
かんぽう	漢方
がんぼう	願望
かんぼく	潅木
かんぼつ	陥没
かんぽん	完本
がんぽん	元本
かんまつ	巻末
かんまん	干満
かんまん	緩慢
かんみ	甘味
がんみ	玩味
かんみん	官民
かんめ	貫目
かんめい	感銘
かんめい	簡明
がんめい	頑冥
がんめん	顔面
がんもく	眼目
かんもん	喚問
かんもん	関門
かんやく	完訳
かんやく	簡約
がんやく	丸薬
かんゆ	肝油
かんゆう	勧誘
がんゆう	含有
かんよ	関与
かんよう	寛容
かんよう	慣用
かんよう	肝要
かんよう	涵養
がんらい	元来
かんらく	歓楽
かんらく	陥落
かんらん	観覧
かんり	官吏
かんり	管理
がんり	元利
がんりき	眼力
かんりゃく	簡略
かんりゅう	寒流
かんりゅう	貫流
かんりゅう	還流
かんりょう	完了
かんりょう	官僚
がんりょく	眼力
かんるい	感涙
かんれい	寒冷
かんれい	慣例
かんれき	官暦
かんれき	還暦
かんれん	関連
かんろ	甘露
がんろう	玩弄
かんろく	貫禄
かんわ	官話
かんわ	漢和
かんわ	緩和
きあい	気合
きあつ	気圧
きあん	起案
ぎあん	議案
きい	キー
きい	奇異
きい	貴意
きいつ	帰一
きいと	生糸
きいろ	黄色
きいん	気韻
きいん	起因
ぎいん	議員
ぎいん	議院
きうん	機運
きえ	帰依
きえい	気鋭
きえつ	喜悦
きえん	奇縁
きえん	機縁
きえん	気焔
ぎえん	義捐
きおう	既往
きおく	記憶
きおん	気温
ぎおん	擬音
きか	奇禍
きか	奇貨
きか	幾何
きか	机下
きか	帰化
きか	気化
きか	貴下
きが	起臥
きが	飢餓
きかい	器械
きかい	奇怪
きかい	機会
きかい	機械
きがい	危害
きがい	気概
ぎかい	議会
きかく	企画
きかく	規格
きがく	器楽
きがる	気軽
きかん	器官
きかん	基幹
きかん	奇観
きかん	旗艦
きかん	既刊
きかん	期間
きかん	機関
きかん	帰還
きかん	気管
きかん	汽罐
きかん	季刊
きかん	亀鑑
きがん	帰雁
きがん	祈願
ぎかん	技官
ぎがん	義眼
きき	危機
きき	嬉々
きき	記紀
きき	聞き
きぎ	機宜
きぎ	木々
ぎぎ	疑義
ききゃく	棄却
ききゅう	危急
ききゅう	気球
ききょ	起居
ききょう	奇矯
ききょう	帰京
ききょう	帰郷
きぎょう	企業
きぎょう	機業
ぎきょう	義侠
ぎきょく	戯曲
ききん	基金
ききん	飢饉
ぎきん	義金
きく	きく
きく	規矩
きく	聞く
きく	利く
きぐ	危惧
きぐ	器具
きぐう	奇遇
きぐう	寄寓
きくか	菊花
きぐらい	気位
きくん	貴君
きけい	奇計
きけい	貴兄
きけい	畸形
ぎけい	義兄
ぎげい	技芸
きげき	喜劇
きけつ	既決
きけつ	帰結
ぎけつ	議決
きけん	危険
きけん	棄権
きけん	貴顕
きげん	期限
きげん	機嫌
きげん	紀元
きげん	起源
きご	季語
きこう	奇行
きこう	寄港
きこう	寄稿
きこう	寄航
きこう	機構
きこう	帰港
きこう	帰航
きこう	気候
きこう	気孔
きこう	紀行
きこう	貴公
きこう	起工
きこう	起稿
きごう	記号
ぎこう	技工
ぎこう	技巧
きこく	帰国
ぎごく	疑獄
きごころ	気心
きこつ	気骨
きこん	既婚
きこん	気魂
きざ	きざ
きさい	奇才
きさい	記載
きさい	起債
きさい	鬼才
きざい	器材
ぎさく	偽作
きさま	貴様
きざみ	刻み
きざむ	刻む
きさん	帰参
きさん	起算
きし	棋士
きし	騎士
きじ	きじ
きじ	記事
きじ	生地
ぎし	技師
ぎし	義士
ぎし	義姉
ぎし	義肢
ぎし	義歯
ぎじ	擬似
ぎじ	議事
ぎしき	儀式
きじく	機軸
きしつ	気質
きじつ	期日
きしべ	岸辺
きしゃ	喜捨
きしゃ	汽車
きしゃ	記者
きしゃく	稀釈
きじゃく	着尺
きしゅ	旗手
きしゅ	騎手
きじゅ	喜寿
ぎしゅ	技手
ぎしゅ	義手
きしゅう	奇習
きしゅう	奇襲
きしゅく	寄宿
きじゅつ	奇術
きじゅつ	記述
ぎじゅつ	技術
きじゅん	基準
きじゅん	帰順
きじょ	貴女
きしょう	奇勝
きしょう	気象
きしょう	気性
きしょう	徽章
きしょう	起床
きじょう	机上
きじょう	気丈
きじょう	軌条
ぎしょう	偽称
ぎしょう	偽証
ぎじょう	議場
きしょく	喜色
きしょく	寄食
きしょく	気色
きしん	寄進
きしん	帰心
きしん	鬼神
きじん	奇人
きじん	貴人
きじん	鬼神
ぎしん	疑心
きす	きす
きず	きず
きずあと	傷跡
きすう	基数
きすう	奇数
きすう	帰趨
きずく	築く
きずぐち	傷口
きずもの	疵物
きせい	奇声
きせい	寄生
きせい	既成
きせい	既製
きせい	期成
きせい	帰省
きせい	気勢
きせい	規制
きせい	規正
ぎせい	擬声
ぎせい	犠牲
きせき	奇蹟
きせき	軌跡
ぎせき	議席
きせつ	既設
きせつ	季節
きぜつ	気絶
きせん	基線
きせん	機先
きせん	汽船
きせん	貴賎
きぜん	毅然
ぎせん	義戦
ぎぜん	偽善
きそ	きそ
きそ	基礎
きそ	起訴
きそう	奇想
きそう	起草
きぞう	寄贈
ぎそう	偽装
ぎそう	艤装
ぎぞう	偽造
きそく	規則
きぞく	帰属
きぞく	貴族
ぎそく	義足
きそん	既存
きそん	毀損
きたい	危殆
きたい	期待
きたい	機体
きたい	気体
きたい	稀代
きだい	季題
きだい	稀代
ぎたい	擬態
ぎだい	議題
きたかぜ	北風
きたく	寄託
きたく	帰宅
きたけ	着丈
きだん	奇談
きだん	気団
きち	危地
きち	基地
きち	既知
きち	機知
きちく	鬼畜
きちじ	吉事
きちじつ	吉日
きちにち	吉日
きちゃく	帰着
きちゅう	忌中
きちょう	基調
きちょう	機長
きちょう	帰朝
きちょう	記帳
きちょう	貴重
ぎちょう	議長
きちれい	吉例
きつえん	喫煙
きつおん	吃音
きっきょう	吉凶
きづけ	気付
きっこう	亀甲
きっこう	拮抗
きっさ	喫茶
きつじつ	吉日
きっすい	喫水
きっすい	生粋
きっちょう	吉兆
きって	切手
きっぷ	切符
きっぽう	吉報
きつもん	詰問
ぎて	技手
きてい	基底
きてい	既定
きてい	規定
ぎてい	義弟
きてき	汽笛
きてん	基点
きてん	機転
きてん	起点
きでん	貴殿
ぎてん	疑点
きと	企図
きと	帰途
きど	喜怒
きど	輝度
きど	木戸
きとう	汽筒
きとう	祈祷
きどう	機動
きどう	起動
きどう	軌道
きとく	危篤
きとく	奇特
きとく	既得
きない	畿内
きなが	気長
きなん	危難
きにち	忌日
きにゅう	記入
きにん	帰任
きぬいと	絹糸
きねん	記念
ぎねん	疑念
きのう	機能
きのう	帰納
きのう	帰農
きのう	気嚢
ぎのう	技能
きのえね	甲子
きのとうし	乙丑
きば	騎馬
きはい	気配
きはく	稀薄
きばこ	木箱
きはつ	揮発
きばつ	奇抜
きばや	気早
きはん	規範
きばん	基盤
きひ	忌避
きび	きび
きび	機微
ぎひつ	偽筆
きびょう	奇病
きひん	気品
きひん	貴賓
きびん	機敏
きふ	寄付
きふ	棋譜
ぎふ	義父
きふう	気風
きふく	帰伏
きふく	起伏
きぶつ	器物
ぎぶつ	偽物
きぶん	奇聞
きぶん	気分
ぎふん	義憤
きへい	騎兵
きへき	奇癖
きべん	詭弁
きぼ	規模
ぎぼ	義母
きほう	既報
きほう	気泡
きぼう	希望
ぎほう	技法
きぼね	気骨
きほん	基本
ぎまい	義妹
きまえ	気前
きまつ	期末
ぎまん	欺瞞
きみ	黄身
きみ	黄味
きみ	気味
きみつ	機密
きみつ	気密
きみどり	黄緑
きみゃく	気脈
きみょう	奇妙
ぎみん	義民
ぎむ	義務
きむすめ	生娘
きめ	きめ
きめ	木目
きめい	記名
ぎめい	偽名
きもの	着物
ぎもん	疑問
きやく	規約
ぎゃくさつ	虐殺
ぎゃくさん	逆算
きゃくし	客死
きゃくしゃ	客車
ぎゃくしゅう	逆襲
ぎゃくじょう	逆上
きゃくしょく	脚色
ぎゃくすう	逆数
きゃくせき	客席
ぎゃくせつ	逆説
ぎゃくぞく	逆賊
きゃくたい	客体
ぎゃくたい	虐待
きゃくちゅう	脚注
ぎゃくて	逆手
ぎゃくてん	逆転
きゃくほん	脚本
きゃくま	客間
ぎゃくよう	逆用
ぎゃくりゅう	逆流
きゃしゃ	華奢
きゃっか	却下
きゃっか	脚下
きゃっかん	客観
ぎゃっきょう	逆境
きゃっこう	脚光
ぎゃっこう	逆行
きゃはん	脚絆
きゆう	杞憂
ぎゆう	義勇
きゅうあく	旧悪
きゅういん	吸引
きゅうえん	救援
きゅうか	休暇
きゅうか	旧家
きゅうかい	休会
きゅうがく	休学
きゅうかん	休刊
きゅうかん	休閑
きゅうかん	急患
きゅうぎ	球戯
きゅうぎ	球技
きゅうきゅう	救急
きゅうきゅう	汲々
きゅうきょ	急遽
きゅうきょ	旧居
きゅうきょう	旧教
きゅうぎょう	休業
きゅうきょく	究極
きゅうきん	給金
きゅうくつ	窮屈
きゅうけい	休憩
きゅうけい	求刑
きゅうけい	球形
きゅうげき	急激
きゅうげき	旧劇
きゅうげん	給源
きゅうご	救護
きゅうこう	休校
きゅうこう	休講
きゅうこう	急行
きゅうこう	旧交
きゅうごう	糾合
きゅうこく	急告
きゅうこく	救国
きゅうこん	求婚
きゅうこん	球根
きゅうさい	救済
きゅうさく	窮策
きゅうさく	旧作
きゅうし	臼歯
きゅうし	休止
きゅうし	急使
きゅうし	急死
きゅうし	旧師
きゅうじ	給仕
きゅうしき	旧式
きゅうしき	旧識
きゅうじつ	休日
きゅうしゃ	廐舎
きゅうしゅう	吸収
きゅうしゅう	急襲
きゅうしゅう	旧習
きゅうしゅう	九州
きゅうじゅう	九十
きゅうじゅつ	救恤
きゅうしょ	急所
きゅうじょ	救助
きゅうじょう	休場
きゅうじょう	宮城
きゅうじょう	球場
きゅうじょう	球状
きゅうじょう	窮状
きゅうしょく	休職
きゅうしょく	求職
きゅうしょく	給食
きゅうしん	休診
きゅうしん	急進
きゅうしん	求心
きゅうしん	球審
きゅうじん	求人
きゅうす	急須
きゅうすい	給水
きゅうすう	級数
きゅうせい	急性
きゅうせい	救世
きゅうせい	旧制
きゅうせい	旧姓
きゅうせき	旧跡
きゅうせん	休戦
きゅうせん	九千
きゅうぞう	急造
きゅうそく	休息
きゅうそく	急速
きゅうたい	旧態
きゅうだい	及第
きゅうだん	球団
きゅうだん	糾弾
きゅうち	窮地
きゅうち	旧知
きゅうちゅう	宮中
きゅうちょう	級長
きゅうてい	宮廷
きゅうてき	仇敵
きゅうてん	急転
きゅうでん	宮殿
きゅうと	旧都
きゅうとう	給湯
きゅうとう	旧套
きゅうどう	弓道
きゅうどう	旧道
きゅうなん	救難
きゅうに	急に
ぎゅうにく	牛肉
きゅうにゅう	吸入
ぎゅうにゅう	牛乳
きゅうねん	旧年
きゅうは	急派
きゅうは	旧派
きゅうば	急場
ぎゅうば	牛馬
きゅうはく	急迫
きゅうはく	窮迫
きゅうはん	急坂
きゅうばん	吸盤
きゅうひ	給費
きゅうひゃく	九百
きゅうびょう	急病
きゅうふ	給付
きゅうぶん	旧聞
きゅうへい	旧弊
きゅうへん	急変
きゅうほう	急報
きゅうぼう	窮乏
きゅうむ	急務
きゅうめい	救命
きゅうめい	究明
きゅうめい	糾明
きゅうもん	糾問
きゅうゆ	給油
きゅうゆう	級友
きゅうゆう	旧友
きゅうよ	窮余
きゅうよ	給与
きゅうよう	休養
きゅうよう	急用
きゅうよう	給養
きゅうらい	旧来
きゅうらく	及落
きゅうり	究理
きゅうりゅう	急流
きゅうりょう	丘陵
きゅうりょう	給料
きゅうれき	旧暦
きゅうろう	旧臘
きよ	寄与
きよい	清い
きよう	器用
きよう	紀要
きよう	起用
きょうあい	狭隘
きょうあく	凶悪
きょうあつ	強圧
きょうい	胸囲
きょうい	脅威
きょうい	驚異
きょういく	教育
きょういん	教員
きょうえい	競泳
きょうえい	共栄
きょうえん	競演
きょうえん	共演
きょうおう	供応
きょうおう	教皇
きょうおう	饗応
きょうか	強化
きょうか	教化
きょうか	教科
きょうか	狂歌
ぎょうが	仰臥
きょうかい	協会
きょうかい	境界
きょうかい	教会
きょうがい	境涯
ぎょうかい	業界
きょうかく	侠客
きょうかく	胸郭
きょうがく	共学
きょうがく	教学
きょうがく	驚愕
ぎょうかく	仰角
きょうかつ	脅喝
きょうかん	兇漢
きょうかん	共感
きょうかん	教官
ぎょうかん	行監
きょうき	侠気
きょうき	凶器
きょうき	狂喜
きょうき	狂気
きょうぎ	競技
きょうぎ	協議
きょうぎ	教義
きょうぎ	狭義
ぎょうぎ	行儀
きょうきゅう	供給
きょうきん	胸襟
きょうく	恐懼
きょうく	狂句
きょうぐ	教具
きょうぐう	境遇
きょうくん	教訓
きょうげき	挾撃
ぎょうけつ	凝結
ぎょうけつ	凝血
きょうけん	強健
きょうけん	強権
きょうけん	狂犬
きょうげん	狂言
きょうこ	強固
ぎょうこ	凝固
きょうこう	凶行
きょうこう	強硬
きょうこう	強行
きょうこう	恐慌
きょうこう	教皇
きょうごう	強豪
ぎょうこう	行幸
ぎょうこう	僥倖
きょうこく	峡谷
きょうこく	強国
きょうさ	教唆
きょうさい	共催
きょうさい	共済
きょうざい	教材
きょうさく	凶作
きょうさく	狭窄
きょうさん	共産
きょうさん	協賛
きょうし	教師
きょうじ	教示
きょうじ	矜持
ぎょうし	凝視
ぎょうじ	行司
ぎょうじ	行事
きょうしつ	教室
きょうしゃ	強者
ぎょうしゃ	業者
ぎょうじゃ	行者
きょうじゃく	強弱
きょうしゅ	興趣
きょうじゅ	享受
きょうじゅ	教授
ぎょうしゅ	業種
きょうしゅう	強襲
きょうしゅう	教習
きょうしゅう	郷愁
ぎょうしゅう	凝集
きょうしゅく	恐縮
きょうしゅつ	供出
きょうじゅつ	供述
きょうじゅん	恭順
きょうしょ	教書
ぎょうしょ	行書
きょうしょう	協商
きょうしょう	狭小
きょうじょう	兇状
きょうじょう	教場
きょうじょう	教条
ぎょうしょう	行商
ぎょうじょう	行状
きょうしょく	教職
きょうしん	強震
きょうじん	兇刃
きょうじん	強靭
きょうじん	狂人
ぎょうずい	行水
きょうせい	強制
きょうせい	強勢
きょうせい	強請
きょうせい	教生
きょうせい	矯正
ぎょうせい	行政
ぎょうせき	業績
ぎょうせき	行跡
きょうそ	教祖
きょうそう	競漕
きょうそう	競争
きょうそう	競走
きょうそう	協奏
きょうそう	強壮
きょうそう	狂躁
きょうぞう	胸像
ぎょうそう	形相
きょうそん	共存
きょうぞん	共存
きょうだ	強打
きょうたい	狂態
きょうたい	嬌態
きょうだい	強大
きょうだい	鏡台
きょうたく	供託
きょうたく	教卓
きょうたん	驚嘆
きょうだん	教団
きょうだん	教壇
きょうち	境地
きょうちゅう	胸中
きょうちょう	凶兆
きょうちょう	協調
きょうちょう	強調
きょうつう	共通
きょうてい	競艇
きょうてい	協定
きょうてい	胸底
きょうてき	強敵
きょうてん	経典
ぎょうてん	仰天
きょうと	教徒
きょうど	強度
きょうど	郷土
きょうとう	教頭
きょうとう	郷党
きょうとう	驚倒
きょうどう	共同
きょうどう	協同
きょうどう	教導
きょうどう	嚮導
きょうねん	享年
きょうばい	競売
きょうはく	脅迫
きょうはん	共犯
きょうふ	恐怖
きょうぶ	胸部
きょうふう	強風
きょうへん	兇変
きょうべん	教鞭
きょうぼう	兇暴
きょうぼう	共謀
きょうぼう	狂暴
きょうぼく	喬木
きょうほん	狂奔
きょうまい	供米
きょうまん	驕慢
きょうみ	興味
きょうむ	教務
ぎょうむ	業務
きょうめい	共鳴
きょうやく	協約
きょうゆ	教諭
きょうゆう	享有
きょうゆう	共有
きょうよ	供与
きょうよう	共用
きょうよう	強要
きょうよう	教養
きょうらく	享楽
きょうらん	狂乱
きょうり	教理
きょうり	郷里
きょうりょう	橋梁
きょうりょう	狭量
きょうりょく	協力
きょうりょく	強力
きょうれつ	強烈
ぎょうれつ	行列
きょうれん	教練
きょうわ	共和
きょうわ	協和
きょえい	虚栄
ぎょえん	御苑
ぎょおざ	餃子
きょか	許可
きょか	炬火
ぎょか	漁火
きょかい	巨魁
ぎょかい	魚介
きょがく	巨額
ぎょかく	漁獲
きょぎ	虚偽
ぎょき	漁期
ぎょきょう	漁協
ぎょぎょう	漁業
きょきん	醵金
ぎょく	漁区
きょくう	極右
きょくがい	局外
きょくぎ	曲技
きょくげい	曲芸
きょくげん	局限
きょくげん	極言
きょくげん	極限
きょくさ	極左
ぎょくざ	玉座
ぎょくさい	玉砕
きょくしゃく	曲尺
きょくしょ	局所
きょくしょう	極小
ぎょくせき	玉石
きょくせつ	曲折
きょくせん	曲線
きょくだい	極大
きょくたん	極端
きょくち	局地
きょくち	極地
きょくち	極致
きょくちょう	局長
きょくちょく	曲直
きょくてん	極点
きょくど	極度
きょくとう	極東
きょくば	曲馬
きょくぶ	局部
きょくめん	局面
きょくめん	曲面
きょくもく	曲目
きょくよう	極洋
きょくりょく	極力
ぎょくろ	玉露
きょくろん	曲論
きょくろん	極論
ぎょけい	魚形
きょこう	挙行
きょこう	虚構
ぎょこう	漁港
きょこく	挙国
きょし	挙止
きょじつ	虚実
ぎょしゃ	御者
きょじゃく	虚弱
きょしゅ	挙手
きょしゅう	去就
きょじゅう	居住
きょしゅつ	拠出
きょしゅつ	醵出
きょしょ	居所
きょしょう	巨匠
きょじょう	居城
ぎょじょう	漁場
きょしょく	虚飾
きょしん	虚心
きょじん	巨人
きょせい	去勢
きょせい	虚勢
ぎょせい	御製
きょぜつ	拒絶
ぎょせん	漁船
きょそ	挙措
ぎょそん	漁村
きょたい	巨体
きょだい	巨大
きょだつ	虚脱
きょっかい	曲解
きょっけい	極刑
きょっこう	極光
きょてん	拠点
きょとう	巨頭
きょどう	挙動
ぎょにく	魚肉
きょねん	去年
ぎょば	漁場
きょひ	巨費
きょひ	拒否
ぎょふ	漁夫
きょへい	挙兵
きょほう	虚報
きょまん	巨万
ぎょみん	漁民
きょむ	虚無
きよめ	清め
きょめい	虚名
きょもう	虚妄
きよもと	清元
きょよう	挙用
きょよう	許容
きょらい	去来
ぎょらい	魚雷
きょり	巨利
きょり	距離
きょりゅう	居留
ぎょるい	魚類
きょれい	虚礼
きら	綺羅
きらい	機雷
きらい	嫌い
きらく	気楽
きり	きり
きり	切り
ぎり	義理
きりあめ	霧雨
きりさめ	霧雨
きりつ	規律
きりつ	起立
きりゃく	機略
きりゅう	寄留
きりゅう	気流
きりょう	器量
きりょく	気力
きる	切る
きる	着る
きるい	着類
きれ	きれ
きれ	切れ
きれい	綺麗
ぎれい	儀礼
きれつ	亀裂
きろ	キロ
きろ	岐路
きろ	帰路
きろく	記録
ぎろん	議論
きわ	きわ
ぎわく	疑惑
きわみ	極み
きわもの	際物
きんあつ	禁圧
きんいつ	均一
きんいろ	金色
ぎんいろ	銀色
きんいん	近因
きんいん	金印
きんえい	近影
きんえん	禁煙
きんか	近火
きんか	金貨
きんが	謹賀
ぎんか	銀貨
ぎんが	銀河
きんかい	欣快
きんかい	近海
きんかい	金塊
きんがく	金額
きんがみ	金紙
ぎんがみ	銀紙
きんかん	近刊
きんがん	近眼
きんき	欣喜
きんき	禁忌
きんき	近畿
きんきゅう	緊急
きんきょう	近況
きんきん	僅々
きんきん	近々
きんぎん	金銀
きんけい	謹啓
きんけい	近景
きんけん	勤倹
きんげん	謹厳
きんげん	金言
きんこ	禁錮
きんこ	近古
きんこ	金庫
きんこう	均衡
きんこう	近郊
きんこう	金工
きんこう	金鉱
きんごう	近郷
ぎんこう	銀行
きんごく	近国
きんこつ	筋骨
きんさ	僅差
ぎんざ	銀座
きんざい	近在
きんさく	金策
きんさつ	禁札
きんざん	金山
ぎんざん	銀山
きんし	勤仕
きんし	禁止
きんし	近視
きんじ	近似
きんじ	近時
きんじ	矜持
きんしつ	均質
きんじつ	近日
きんしゅ	禁酒
きんしゅ	金主
きんじゅう	禽獣
きんしゅく	緊縮
きんしょ	禁書
きんじょ	近所
きんしょう	僅少
きんじょう	近情
きんじょう	近状
ぎんじょう	吟醸
きんしん	謹慎
きんしん	近親
きんす	金子
きんすじ	金筋
きんせい	均斉
きんせい	禁制
きんせい	謹製
きんせい	近世
きんせい	金星
きんせい	金製
きんせつ	緊切
きんせつ	近接
きんせん	金銭
きんそく	禁足
きんぞく	勤続
きんぞく	金属
きんだ	勤惰
きんだい	近代
きんだか	金高
きんだち	公達
きんだん	禁断
きんちゃく	巾着
きんちゃく	近着
きんちょう	緊張
きんちょう	謹聴
きんちょく	謹直
きんでい	金泥
きんてき	金的
きんど	襟度
きんとう	均等
きんとう	近東
きんとき	金時
きんにく	筋肉
きんねん	近年
きんのう	勤王
きんぱく	緊迫
きんぱく	金箔
ぎんぱく	銀白
きんぱつ	金髪
ぎんばん	銀盤
きんぴん	金品
きんぶち	金縁
きんぶん	均分
きんべん	勤勉
きんぺん	近辺
きんぼ	欣慕
きんぼう	近傍
ぎんまく	銀幕
ぎんみ	吟味
きんみつ	緊密
きんむ	勤務
きんもつ	禁物
きんゆ	禁輸
きんゆう	金融
きんよう	緊要
きんよう	金曜
きんよく	禁欲
きんらい	近来
きんり	金利
きんりょう	禁猟
きんりょく	金力
きんりん	近隣
きんるい	菌類
きんれい	禁令
きんろう	勤労
ぐあい	具合
くい	悔い
ぐい	ぐい
くいき	区域
くう	食う
ぐう	グウ
くうい	空位
ぐうい	寓意
くうかん	空間
くうき	空気
くうきょ	空虚
ぐうきょ	寓居
くうぐん	空軍
くうげき	空隙
くうこう	空港
くうしゃ	空車
くうしゅう	空襲
くうしょう	空将
ぐうすう	偶数
くうせき	空席
くうぜん	空前
ぐうぜん	偶然
くうそ	空疎
くうそう	空想
ぐうぞう	偶像
くうちゅう	空中
くうどう	空洞
くうはく	空白
くうばく	空爆
ぐうはつ	偶発
くうひ	空費
くうふく	空腹
くうぶん	空文
くうぼ	空母
くうほう	空砲
くうゆ	空輸
くうり	空理
くうろ	空路
くうろん	空論
ぐうわ	寓話
くえき	苦役
くおん	久遠
くかく	区画
くがく	苦学
くかん	区間
ぐがん	具眼
くきょう	苦境
くぎょう	苦行
くぎょう	公卿
くく	九々
くく	区々
くくり	括り
くぐり	潜り
くぐる	潜る
くけい	矩形
くげん	苦言
ぐげん	具現
ぐさ	ぐさ
くさい	臭い
くさいろ	草色
くさかげ	草陰
くさき	草木
くさたけ	草丈
くさば	草葉
くさばな	草花
くさはら	草原
くさぶえ	草笛
くさまくら	草枕
くさみ	臭み
くさもち	草餅
くさり	腐り
くし	駆使
くじ	くじ
くしがき	串柿
ぐしゃ	愚者
くじゅ	口授
くしゅう	句集
くじゅう	苦渋
くじょ	駆除
くしょう	苦笑
くじょう	苦情
ぐしょう	具象
くしん	苦心
ぐしん	具申
ぐじん	愚人
くず	くず
ぐず	ぐず
くずや	屑屋
くすりや	薬屋
くすりゆび	薬指
くずれ	崩れ
くせもの	曲者
くせん	苦戦
くそ	くそ
ぐそう	愚僧
ぐそく	具足
ぐそく	愚息
ぐたい	具体
くだし	下し
くだり	下り
くだんの	件の
ぐち	ぐち
くちえ	口絵
くちかず	口数
くちがね	口金
くちく	駆逐
くちぐせ	口癖
くちぐち	口々
くちぐるま	口車
くちさき	口先
くちび	口火
くちぶえ	口笛
くちべに	口紅
くちゅう	苦衷
くちょう	区長
くちょう	口調
ぐちょく	愚直
ぐっ	ぐっ
くつう	苦痛
くつおと	靴音
くっきょう	究竟
くっきょう	屈強
くっきょく	屈曲
くっし	屈指
くつした	靴下
くつじゅう	屈従
くつじょく	屈辱
くっしん	屈伸
くつずみ	靴墨
くっせつ	屈折
くったく	屈託
くっぷく	屈伏
くつや	靴屋
くてん	句点
くでん	口伝
くとう	苦闘
くどく	功徳
ぐどん	愚鈍
くなん	苦難
くにがら	国柄
くにぐに	国々
くにたみ	国民
くにのみやつこ	国造
くにべつ	国別
くにもと	国許
くのう	苦悩
くばり	配り
くばる	配る
くび	くび
ぐび	具備
くびまき	首巻
くびわ	首輪
ぐぶ	供奉
ぐふう	颶風
くぶん	区分
くべつ	区別
くぼち	窪地
くま	くま
ぐまい	愚昧
くまそ	熊襲
くまで	熊手
くみ	苦味
くみ	組み
ぐみ	ぐみ
くみあい	組合
くみきょく	組曲
くみちょう	組長
くみはん	組版
ぐみん	愚民
くむ	汲む
くむ	組む
くめん	工面
くも	くも
くもすけ	雲助
くもつ	供物
くもま	雲間
くもり	曇り
くもる	曇る
くもん	苦悶
ぐもん	愚問
くやみ	悔み
くよう	供養
くらい	暗い
くらく	苦楽
くらべ	比べ
くり	くり
くり	庫裡
くりょ	苦慮
くる	繰る
くる	来る
くる	刳る
ぐる	ぐる
くるい	狂い
くるう	狂う
くるまざ	車座
くれ	暮れ
ぐれつ	愚劣
くろい	黒い
くろう	苦労
ぐろう	愚弄
くろうと	玄人
くろかみ	黒髪
くろくも	黒雲
くろぐろ	黒々
くろじ	黒字
くろしお	黒潮
くろつち	黒土
くろふね	黒船
くろぼし	黒星
くろまく	黒幕
くろめ	黒目
くろやま	黒山
ぐろん	愚論
くわ	くわ
くわだて	企て
くわばたけ	桑畑
ぐんい	軍医
くんいく	訓育
ぐんか	軍歌
くんかい	訓戒
ぐんかく	軍拡
ぐんかん	軍艦
ぐんき	軍旗
ぐんき	軍機
ぐんき	軍紀
ぐんきょ	群居
くんこう	勲功
ぐんこう	軍港
くんこく	君国
くんこく	訓告
ぐんこく	軍国
くんし	君子
くんじ	訓示
くんじ	訓辞
ぐんし	軍使
ぐんじ	軍事
くんしゅ	君主
ぐんじゅ	軍需
ぐんしゅう	群衆
ぐんしゅう	群集
ぐんしゅく	軍縮
くんしょう	勲章
ぐんしょう	群小
くんしん	君臣
ぐんしん	群臣
ぐんじん	軍人
くんせい	燻製
ぐんせい	群棲
ぐんせい	軍政
ぐんぜい	軍勢
ぐんせき	軍籍
ぐんそう	軍曹
ぐんぞう	群像
ぐんぞく	軍属
ぐんたい	軍隊
くんとう	勲等
くんとう	薫陶
ぐんとう	群島
ぐんとう	軍刀
くんどく	訓読
ぐんば	軍馬
ぐんばい	軍配
ぐんばつ	軍閥
ぐんび	軍備
ぐんぴ	軍費
ぐんぴょう	軍票
ぐんぶ	群舞
ぐんぶ	軍部
ぐんぶ	郡部
くんぷう	薫風
ぐんぷく	軍服
くんめい	君命
ぐんもん	軍門
くんゆ	訓諭
ぐんゆう	群雄
ぐんよう	軍用
ぐんらく	群落
ぐんりつ	軍律
くんりん	君臨
くんれい	訓令
くんれん	訓練
くんわ	訓話
げ	−げ
けあな	毛穴
けいあい	敬愛
けいい	敬意
けいい	経緯
げいいき	芸域
けいえい	経営
けいえん	敬遠
けいおう	慶応
けいか	経過
けいが	慶賀
けいかい	境界
けいかい	警戒
けいかい	軽快
けいがい	形骸
けいがい	謦咳
けいかく	圭角
けいかく	計画
けいかん	景観
けいかん	警官
けいがん	慧眼
けいき	刑期
けいき	契機
けいき	景気
けいき	計器
げいぎ	芸妓
けいきょ	軽挙
けいきょう	景況
けいく	警句
けいぐ	敬具
けいけい	軽々
けいけい	烱々
けいけん	敬虔
けいけん	経験
けいげん	軽減
けいこ	稽古
けいご	敬語
けいご	警護
けいこう	傾向
けいこう	携行
けいこう	螢光
げいごう	迎合
けいこく	経国
けいこく	警告
けいこく	谿谷
げいごと	芸事
けいさい	掲載
けいさい	荊妻
けいざい	経済
けいさつ	警察
けいさん	計算
けいし	継子
けいし	罫紙
けいし	警視
けいし	軽視
けいじ	刑事
けいじ	兄事
けいじ	啓示
けいじ	慶事
けいじ	掲示
けいしき	形式
けいしゃ	傾斜
げいしゃ	芸者
けいしゅう	閨秀
けいじゅう	軽重
けいしゅく	慶祝
げいじゅつ	芸術
けいしょう	形象
けいしょう	敬称
けいしょう	景勝
けいしょう	継承
けいしょう	警鐘
けいしょう	軽傷
けいしょう	軽少
けいしょう	軽症
けいじょう	刑場
けいじょう	形状
けいじょう	敬譲
けいじょう	経常
けいじょう	計上
けいじょう	警乗
けいしん	敬神
けいしん	軽信
けいず	系図
けいすう	係数
けいすう	計数
けいせい	傾城
けいせい	形勢
けいせい	形成
けいせい	経世
けいせい	警世
けいせい	警醒
けいせき	形跡
けいせん	罫線
けいそう	係争
けいそう	継走
けいそう	軽装
けいそう	軽躁
けいぞく	継続
けいそつ	軽率
けいたい	形態
けいたい	携帯
けいだい	境内
けいちゅう	傾注
けいちょう	傾聴
けいちょう	慶弔
けいちょう	慶長
けいちょう	軽重
けいちょう	軽佻
けいてい	兄弟
けいてい	逕庭
けいてき	警笛
けいてん	経典
けいと	毛糸
けいど	経度
けいど	軽度
けいとう	傾倒
けいとう	系統
げいとう	芸当
げいどう	芸道
けいにく	鶏肉
げいにん	芸人
げいのう	芸能
けいば	競馬
けいはい	硅肺
けいばい	競売
けいはく	軽薄
けいはつ	啓発
けいばつ	刑罰
けいばつ	閨閥
けいひ	経費
けいび	警備
けいび	軽微
けいひん	景品
けいふ	系譜
けいふ	継父
けいぶ	警部
けいぶ	軽侮
げいふう	芸風
けいふく	敬服
けいぶつ	景物
けいふん	鶏糞
けいべつ	軽蔑
けいべん	軽便
けいぼ	敬慕
けいぼ	継母
けいほう	刑法
けいほう	警報
けいぼう	警防
けいみょう	軽妙
けいむ	刑務
けいめい	鶏鳴
げいめい	芸名
けいもう	啓蒙
けいやく	契約
けいゆ	経由
けいよう	形容
けいよう	掲揚
けいら	警邏
けいらん	鶏卵
けいり	経理
けいりゃく	計略
けいりゅう	渓流
けいりゅう	繋留
けいりょう	計量
けいりん	競輪
けいりん	経綸
けいるい	係累
けいれい	敬礼
けいれき	経歴
けいれつ	系列
けいれん	痙攣
けいろ	経路
けいろ	毛色
けいろう	敬老
けう	稀有
けおり	毛織
けが	怪我
げか	外科
げかい	下界
けがれ	汚れ
けがわ	毛皮
げきえつ	激越
げきか	激化
げきげん	激減
げきこう	激昂
げきさく	劇作
げきしょう	激賞
げきじょう	劇場
げきじょう	激情
げきしん	激震
げきせん	激戦
げきぞう	激増
げきたい	撃退
げきだん	劇団
げきちん	撃沈
げきつい	撃墜
げきつう	劇痛
げきど	激怒
げきどう	激動
げきとつ	激突
げきは	撃破
げきはつ	激発
げきひょう	劇評
げきへん	激変
げきむ	劇務
げきめつ	撃滅
げきやく	劇薬
げきりゅう	激流
げきりん	逆鱗
げきれい	激励
げきれつ	激烈
げきろう	激浪
げきろん	激論
けげん	怪訝
げこ	下戸
げこう	下向
げこう	下校
けさ	けさ
けさ	袈裟
げざ	下座
げざい	下剤
げざん	下山
けし	けし
げし	夏至
げじ	下知
けしき	景色
げしゃ	下車
げしゅく	下宿
げじゅん	下旬
げじょ	下女
けしょう	化粧
けしん	化身
けす	消す
げす	下司
げすい	下水
けずる	削る
げせん	下賎
けそう	懸想
げそく	下足
けた	けた
げた	下駄
げだい	外題
げだつ	解脱
げだん	下段
けち	けち
げち	下知
けちえん	結縁
けつ	けつ
けつあつ	血圧
けつい	決意
けついん	欠員
けつえき	血液
けつえん	血縁
けっか	欠課
けっか	結果
けっか	結跏
げっか	激化
げっか	月下
けっかい	決壊
けっかく	結核
けっかん	欠陥
けっかん	血管
げっかん	月刊
げっかん	月間
けっき	血気
けっき	蹶起
けつぎ	決議
けっきゅう	血球
げっきゅう	月給
けっきょ	穴居
けっきょく	結局
けっきん	欠勤
けっく	結句
げっけい	月経
けっこう	欠航
けっこう	決行
けっこう	結構
けっこう	血行
けつごう	結合
げっこう	激昂
げっこう	月光
けっこん	結婚
けっこん	血痕
けっさい	決済
けっさい	決裁
けっさく	傑作
けっさん	決算
げっさん	月産
けっし	決死
けつじ	欠字
けつじつ	結実
けっしゃ	結社
げっしゃ	月謝
けっしゅう	結集
げっしゅう	月収
けっしゅつ	傑出
けっしょ	血書
けつじょ	欠如
けっしょう	決勝
けっしょう	結晶
けっしょう	血漿
けっしょく	欠食
けっしょく	血色
げっしょく	月食
けっしん	決心
けっしん	結審
けっせい	結成
けっせい	血清
けっせき	欠席
けっせん	決戦
けっせん	決選
けつぜん	決然
けっそう	血相
けっそく	結束
けつぞく	血族
けっそん	欠損
けったい	結滞
けったく	結託
けつだん	決断
けっちゃく	決着
けっちん	血沈
けってい	決定
けってん	欠点
けっとう	決闘
けっとう	血統
けっぱく	潔白
けっぱつ	結髪
けっぱん	血判
けっぴょう	結氷
げっぷ	月賦
けつぶつ	傑物
けっぺき	潔癖
けつべつ	訣別
けつぼう	欠乏
げっぽう	月俸
げっぽう	月報
けっぽん	欠本
けつまつ	結末
げつまつ	月末
げつめい	月明
げつよ	月余
げつよう	月曜
けつるい	血涙
けつれい	欠礼
げつれい	月齢
けつれつ	決裂
けつろ	血路
けつろん	結論
けとう	毛唐
げどう	外道
けなげ	健気
げなん	下男
げに	げに
けねん	懸念
けば	けば
げば	下馬
けはい	気配
げはん	下阪
けびょう	仮病
げひん	下品
けぶい	煙い
けむい	煙い
けむし	毛虫
げめん	外面
げや	下野
けらい	家来
げらく	下落
けり	けり
げり	下痢
ける	ける
げれつ	下劣
けんあく	険悪
けんあん	懸案
げんあん	原案
けんい	権威
けんいん	検印
げんいん	原因
げんいん	減員
げんえい	幻影
けんえき	検疫
けんえき	権益
げんえき	現役
けんえつ	検閲
けんお	嫌悪
けんおん	検温
けんか	喧嘩
げんか	原価
げんか	現下
げんか	絃歌
げんか	言下
けんかい	県会
けんかい	見解
けんがい	圏外
けんがい	懸崖
げんかい	限界
げんがい	言外
けんかく	懸隔
けんがく	見学
げんかく	厳格
げんかく	幻覚
げんがく	減額
げんがく	絃楽
けんかん	兼官
けんかん	顕官
けんがん	検眼
げんかん	厳寒
げんかん	玄関
けんぎ	嫌疑
けんぎ	建議
げんき	元気
けんきゃく	健脚
けんきゅう	研究
げんきゅう	言及
けんきょ	検挙
けんきょ	謙虚
けんぎょう	兼業
げんきょう	現況
げんぎょう	現業
けんきん	献金
げんきん	厳禁
げんきん	現金
げんけい	原型
げんけい	原形
げんけい	減刑
けんげき	剣劇
げんげつ	弦月
けんげん	権限
けんげん	顕現
けんご	堅固
げんご	原語
げんご	言語
けんこう	健康
けんこう	軒昂
けんごう	剣豪
げんこう	原稿
げんこう	現行
げんこう	言行
げんごう	元号
けんこく	建国
げんこく	原告
げんこつ	拳骨
けんこん	乾坤
げんこん	現今
けんさ	検査
けんざい	健在
けんざい	顕在
げんざい	原罪
げんざい	現在
けんさく	検索
げんさく	原作
けんさつ	検察
けんさつ	検札
けんさん	研鑚
けんざん	検算
げんさん	原産
げんさん	減産
けんし	検視
けんし	犬歯
けんし	絹糸
けんじ	健児
けんじ	堅持
けんじ	検事
げんし	原始
げんし	原子
げんし	原紙
げんし	幻視
げんじ	源氏
げんじ	現時
げんじ	言辞
けんしき	見識
けんじつ	堅実
げんじつ	現実
けんじゃ	賢者
げんしゅ	元首
げんしゅ	厳守
けんしゅう	研修
けんじゅう	拳銃
げんしゅう	減収
げんじゅう	厳重
げんしゅく	厳粛
けんしゅつ	検出
げんしゅつ	現出
けんしゅん	険峻
げんしょ	原書
けんしょう	健勝
けんしょう	憲章
けんしょう	懸賞
けんしょう	検証
けんしょう	肩章
けんしょう	顕彰
けんじょう	献上
けんじょう	謙譲
げんしょう	減少
げんしょう	現象
げんじょう	現場
げんじょう	現状
けんしょく	顕職
げんしょく	原色
げんしょく	現職
けんしん	検診
けんしん	検針
けんしん	献身
けんじん	賢人
げんしん	原審
げんじん	原人
けんすい	懸垂
げんすい	元帥
げんすい	減水
けんすう	件数
げんすん	原寸
げんせ	現世
げんぜ	現世
けんせい	憲政
けんせい	権勢
けんせい	牽制
げんせい	原生
げんせい	厳正
げんせい	現勢
げんぜい	減税
けんせき	譴責
げんせき	原籍
けんせつ	兼摂
けんせつ	建設
げんせつ	言説
けんぜん	健全
けんぜん	顕然
げんせん	厳選
げんせん	源泉
げんぜん	厳然
げんぜん	現前
けんそ	険阻
げんそ	元素
けんそう	喧騒
けんぞう	建造
げんそう	幻想
げんそう	舷窓
げんぞう	現像
けんそく	検束
けんぞく	眷族
げんそく	原則
げんそく	舷側
げんぞく	還俗
けんそん	謙遜
げんそん	現存
けんたい	倦怠
げんたい	原隊
げんたい	減退
げんだい	現代
けんだく	懸濁
けんたん	健啖
げんたん	原炭
けんち	見地
げんち	現地
げんち	言質
けんちく	建築
けんちょ	顕著
げんちょ	原著
けんちょう	堅調
けんちょう	県庁
げんちょう	幻聴
けんつく	剣突
けんてい	検定
けんてい	献呈
げんてい	限定
けんてつ	賢哲
けんでん	喧伝
げんてん	減点
げんど	限度
けんとう	健闘
けんとう	拳闘
けんとう	検討
けんとう	見当
けんどう	剣道
けんどう	県道
げんとう	厳冬
げんとう	幻燈
げんどう	言動
けんない	圏内
げんに	厳に
げんに	現に
けんにん	兼任
けんのう	権能
けんのう	献納
けんのん	剣呑
げんば	現場
げんぱい	減配
けんぱく	建白
げんばく	原爆
げんばつ	厳罰
けんばん	鍵盤
げんばん	原板
げんばん	原版
けんび	兼備
げんぴ	厳秘
げんぴん	現品
けんぶ	剣舞
けんぷ	絹布
げんぷ	厳父
げんぷう	厳封
げんぷく	元服
けんぶつ	見物
げんぶつ	現物
けんぶん	検分
けんぶん	見聞
げんぶん	原文
けんぺい	憲兵
げんぺい	源平
けんべん	検便
げんぼ	原簿
けんぼう	権謀
けんぽう	憲法
げんぽう	減俸
げんぽう	減法
けんま	研磨
げんまい	玄米
けんまく	権幕
げんみつ	厳密
けんむ	兼務
けんめい	懸命
けんめい	賢明
げんめい	厳命
げんめい	言明
げんめつ	幻滅
げんめん	原綿
げんめん	減免
けんもん	検問
けんもん	権門
けんもん	見聞
げんや	原野
けんやく	倹約
げんゆ	原油
けんよう	兼用
けんらん	絢爛
けんり	権利
げんり	原理
けんりつ	県立
げんりゅう	源流
けんりょう	見料
げんりょう	原料
けんりょく	権力
けんろう	堅牢
げんろう	元老
げんろく	元禄
げんろん	言論
げんわく	幻惑
こい	こい
こい	故意
こい	請い
こい	濃い
ごい	語意
ごい	語彙
こいき	小粋
こいし	小石
ごいし	碁石
こいなか	恋仲
こいびと	恋人
こいぶみ	恋文
こいん	雇員
こう	こう
こう	乞う
こうあつ	高圧
こうあん	公安
こうあん	考案
こうい	厚意
こうい	好意
こうい	校医
こうい	皇位
こうい	行為
こうい	高位
ごうい	合意
ごういつ	合一
こういん	後胤
こういん	光陰
こういん	工員
こういん	拘引
ごういん	強引
こうう	降雨
ごうう	豪雨
こううん	幸運
こうえい	後衛
こうえい	後裔
こうえい	光栄
こうえい	公営
こうえき	交易
こうえき	公益
こうえつ	校閲
こうえん	後援
こうえん	公園
こうえん	公演
こうえん	口演
こうえん	好演
こうえん	講演
こうえん	高遠
こうお	好悪
こうおつ	甲乙
こうおん	厚恩
こうおん	高温
こうおん	高音
ごうおん	轟音
こうか	公課
こうか	効果
こうか	工科
こうか	校歌
こうか	硬化
こうか	硬貨
こうか	降下
こうか	高価
こうか	高架
こうが	高雅
ごうか	豪華
こうかい	後悔
こうかい	公海
こうかい	公開
こうかい	航海
こうかい	降灰
こうがい	公害
こうがい	口外
こうがい	校外
こうがい	梗概
こうがい	港外
こうがい	郊外
こうがい	慷慨
ごうがい	号外
こうがく	後学
こうがく	光学
こうがく	好学
こうがく	工学
こうがく	高額
ごうかく	合格
こうかつ	狡猾
こうかん	交換
こうかん	交歓
こうかん	好感
こうかん	好漢
こうかん	浩瀚
こうかん	鋼管
こうかん	高官
こうがん	厚顔
こうがん	紅顔
こうがん	睾丸
ごうかん	強姦
こうき	興起
こうき	後期
こうき	後記
こうき	光輝
こうき	公器
こうき	好奇
こうき	好機
こうき	校旗
こうき	校規
こうき	皇紀
こうき	綱紀
こうき	航機
こうき	香気
こうき	高貴
こうぎ	好誼
こうぎ	広義
こうぎ	抗議
こうぎ	講義
ごうき	豪気
ごうぎ	合議
こうきゅう	公休
こうきゅう	恒久
こうきゅう	硬球
こうきゅう	考究
こうきゅう	高級
ごうきゅう	号泣
こうきょ	公許
こうきょ	皇居
こうきょ	薨去
こうきょう	交響
こうきょう	公共
こうきょう	口供
こうきょう	好況
こうぎょう	興業
こうぎょう	興行
こうぎょう	工業
こうぎょう	鉱業
こうきん	公金
こうきん	拘禁
ごうきん	合金
こうぐ	工具
こうくう	口腔
こうくう	航空
こうくう	高空
こうぐう	厚遇
こうくん	校訓
こうぐん	行軍
こうげ	香華
こうげ	高下
こうけい	後継
こうけい	光景
こうけい	口径
こうけい	肯綮
こうげい	工芸
ごうけい	合計
こうげき	攻撃
こうけつ	膏血
こうけつ	高潔
ごうけつ	豪傑
こうけん	後見
こうけん	効験
こうけん	貢献
こうげん	光源
こうげん	公言
こうげん	広言
こうげん	高原
こうげん	高言
ごうけん	剛健
ごうけん	合憲
こうこ	後顧
こうこ	公庫
こうこ	好個
こうこ	江湖
こうご	交互
こうご	口語
こうご	向後
ごうご	豪語
こうこう	口腔
こうこう	孝行
こうこう	航行
こうこう	高校
こうこう	煌々
こうごう	皇后
ごうごう	轟々
こうこく	興国
こうこく	公告
こうこく	広告
こうこく	抗告
こうこく	皇国
こうこつ	硬骨
こうこつ	恍惚
こうさ	較差
こうさ	交叉
こうさ	公差
こうさ	考査
こうざ	口座
こうざ	講座
こうさい	交際
こうさい	光彩
こうさい	公債
こうざい	功罪
こうざい	鋼材
こうさく	交錯
こうさく	工作
こうさく	耕作
こうさつ	絞殺
こうさつ	考察
こうさん	公算
こうさん	恒産
こうさん	降参
こうざん	鉱山
こうざん	高山
こうし	格子
こうし	公使
こうし	公司
こうし	公私
こうし	厚志
こうし	孝子
こうし	行使
こうし	講師
こうし	嚆矢
こうじ	後事
こうじ	公示
こうじ	工事
こうじ	講師
こうじ	小路
ごうし	合資
ごうし	合祀
こうしき	公式
こうしつ	皇室
こうしつ	硬質
こうじつ	口実
こうしゃ	後者
こうしゃ	公舎
こうしゃ	公社
こうしゃ	巧者
こうしゃ	校舎
ごうしゃ	豪奢
こうしゃく	公爵
こうしゃく	講釈
こうしゅ	好手
こうしゅ	工手
こうしゅ	攻守
こうじゅ	口授
こうしゅう	公衆
こうしゅう	口臭
こうしゅう	講習
こうじゅつ	後述
こうじゅつ	口述
こうしょ	高所
こうじょ	公序
こうじょ	控除
こうしょう	交渉
こうしょう	公娼
こうしょう	公称
こうしょう	工廠
こうしょう	考証
こうしょう	高唱
こうしょう	高尚
こうしょう	哄笑
こうじょう	交情
こうじょう	厚情
こうじょう	口上
こうじょう	向上
こうじょう	工場
ごうしょう	豪商
ごうじょう	強情
こうしょく	黄色
こうしょく	公職
こうしょく	好色
こうしょく	降職
こうしん	後身
こうしん	後進
こうしん	功臣
こうしん	孝心
こうしん	昂進
こうしん	更新
こうしん	行進
こうじん	黄塵
こうじん	公人
こうじん	幸甚
こうじん	荒神
こうず	構図
こうすい	硬水
こうすい	香水
こうずい	洪水
こうずい	香水
こうせい	後世
こうせい	公正
こうせい	厚生
こうせい	恒星
こうせい	抗生
こうせい	攻勢
こうせい	更正
こうせい	更生
こうせい	校正
こうせい	構成
こうせい	高声
ごうせい	強請
ごうせい	合成
ごうせい	豪勢
こうせき	功績
こうせき	航跡
こうせき	鉱石
こうせつ	交接
こうせつ	公設
こうせつ	巧拙
こうせつ	巷説
こうせつ	降雪
こうせつ	高説
ごうせつ	豪雪
こうせん	交戦
こうせん	光線
こうせん	公選
こうせん	口銭
こうせん	抗戦
こうせん	鉱泉
こうぜん	公然
こうぜん	昂然
こうぜん	浩然
ごうぜん	轟然
ごうぜん	傲然
こうそ	公訴
こうそ	控訴
こうそ	酵素
こうそう	広壮
こうそう	抗争
こうそう	構想
こうそう	高僧
こうそう	高層
こうぞう	構造
ごうそう	豪壮
こうそく	拘束
こうそく	校則
こうそく	高速
こうぞく	後続
こうぞく	皇族
ごうぞく	豪族
こうそん	皇孫
こうた	小唄
こうだ	好打
こうたい	後退
こうたい	交替
こうだい	後代
こうだい	広大
こうたく	光沢
ごうだつ	強奪
こうたん	降誕
こうだん	公団
こうだん	講壇
こうだん	講談
こうだん	降壇
こうだん	高段
ごうたん	剛胆
こうち	巧遅
こうち	巧緻
こうち	拘置
こうち	耕地
こうち	高地
こうちく	構築
こうちゃ	紅茶
こうちゃく	膠着
こうちゅう	甲虫
こうちょう	候鳥
こうちょう	公聴
こうちょう	好調
こうちょう	校長
こうちょう	紅潮
こうちょく	硬直
ごうちょく	剛直
こうちん	工賃
ごうちん	轟沈
こうつう	交通
こうてい	公定
こうてい	工程
こうてい	校庭
こうてい	皇帝
こうてい	肯定
こうてい	航程
こうてい	行程
こうてい	高低
こうてい	高弟
こうでい	拘泥
こうてき	好適
こうてつ	交迭
こうてつ	鋼鉄
こうてん	交点
こうてん	公転
こうてん	好天
こうてん	好転
こうてん	荒天
こうでん	公電
こうでん	香奠
こうど	光度
こうど	硬度
こうど	耕土
こうど	高度
こうとう	口頭
こうとう	喉頭
こうとう	昂騰
こうとう	降等
こうとう	高等
こうどう	黄道
こうどう	坑道
こうどう	行動
こうどう	講堂
ごうとう	強盗
ごうどう	合同
こうとく	公徳
こうとく	高徳
こうどく	講読
こうどく	購読
こうどく	鉱毒
こうない	坑内
こうない	校内
こうない	構内
こうない	港内
こうなん	後難
こうにゅう	購入
こうにん	後任
こうにん	公認
こうねつ	光熱
こうねん	後年
こうねん	光年
こうねん	行年
こうのう	効能
ごうのう	豪農
こうば	工場
こうはい	興廃
こうはい	後輩
こうはい	交配
こうはい	向背
こうはい	荒廃
こうばい	勾配
こうばい	購買
こうはく	紅白
こうばく	広漠
こうはつ	後発
ごうはら	業腹
こうはん	撹拌
こうはん	後半
こうはん	公判
こうはん	孔版
こうはん	甲板
こうばん	交番
こうばん	甲板
こうひ	公費
こうひ	口碑
こうひ	工費
こうび	交尾
こうひつ	硬筆
こうひょう	公表
こうひょう	好評
こうひょう	講評
こうひょう	高評
こうびん	後便
こうびん	幸便
こうふ	交付
こうふ	公布
こうふ	坑夫
こうふ	工夫
こうふ	弘布
こうぶ	後部
こうふう	校風
こうふく	幸福
こうふく	降伏
こうふく	降服
こうぶつ	好物
こうぶつ	鉱物
こうふん	興奮
こうふん	公憤
こうふん	口吻
こうぶん	公文
こうぶん	構文
こうぶん	行文
こうへい	公平
こうへい	工兵
こうべい	向米
こうへん	後篇
こうべん	抗弁
こうほ	候補
こうぼ	公募
こうぼ	酵母
こうほう	後方
こうほう	公報
こうほう	工法
こうほう	広報
こうほう	高峰
こうぼう	興亡
こうぼう	攻防
ごうほう	号砲
ごうほう	合法
ごうほう	豪放
こうぼく	公僕
こうぼく	高木
こうほん	校本
こうほん	稿本
こうまん	高慢
ごうまん	傲慢
こうみゃく	鉱脈
こうみょう	光明
こうみょう	功名
こうみょう	巧妙
こうみん	公民
こうむ	公務
こうむ	工務
こうむる	蒙る
こうめい	公明
こうめい	高名
こうもく	綱目
こうもく	項目
こうもん	校門
こうもん	肛門
ごうもん	拷問
こうや	荒野
こうや	高野
こうやく	公約
こうやく	口約
こうやく	膏薬
こうゆう	交友
こうゆう	公有
こうゆう	校友
ごうゆう	豪遊
こうよう	公用
こうよう	効用
こうよう	孝養
こうよう	紅葉
こうよう	高揚
ごうよく	強欲
こうら	甲羅
こうらく	行楽
こうらん	撹乱
こうり	公吏
こうり	公理
こうり	功利
こうり	行李
こうり	高利
こうり	小売
ごうり	合理
ごうりき	強力
こうりつ	公立
こうりつ	効率
こうりつ	高率
こうりゃく	攻略
こうりゅう	興隆
こうりゅう	交流
こうりゅう	拘留
ごうりゅう	合流
こうりょ	考慮
こうりょう	校了
こうりょう	綱領
こうりょう	荒涼
こうりょう	香料
こうりょく	効力
こうれい	好例
こうれい	恒例
こうれい	高齢
ごうれい	号令
こうれつ	後列
こうろ	航路
こうろ	行路
こうろ	高炉
こうろう	功労
こうろん	公論
こうろん	口論
こうわ	講話
こうわ	媾和
こうわん	港湾
こえ	肥え
ごえ	越え
ごえい	護衛
こえだ	小枝
こおう	呼応
こおとこ	小男
こおりまくら	氷枕
こおりみず	氷水
こおる	凍る
ごおん	呉音
こか	古歌
こが	古雅
こがい	戸外
ごかい	誤解
ごかく	互角
ごがく	語学
こかげ	木陰
こかた	子方
こがた	小型
ごがたき	碁敵
こがたな	小刀
こかつ	枯渇
こがら	小柄
ごかん	五官
ごかん	五感
ごかん	語幹
ごかん	語感
ごがん	護岸
こき	古稀
ごき	語気
ごぎ	語義
こきゅう	呼吸
こきゅう	故旧
こきょう	故郷
こく	こく
こぐ	漕ぐ
ごく	ごく
ごく	語句
ごくあく	極悪
こくい	国威
ごくい	極意
こくいん	刻印
こくう	虚空
こくうん	国運
こくうん	黒雲
こくえい	国営
こくおう	国王
こくがい	国外
こくがく	国学
こくぎ	国技
こくきょう	国境
こくぐら	穀倉
こくげん	刻限
こくご	国語
こくごう	国号
こくさい	国債
こくさい	国際
こくさく	国策
こくさん	国産
こくし	国史
こくし	酷使
こくじ	告示
こくじ	国事
こくじ	国字
こくじ	国璽
こくじ	酷似
ごくし	獄死
ごくしゃ	獄舎
こくしゅ	国手
こくしょ	国書
こくしょ	酷暑
ごくしょ	極暑
こくじょう	国情
ごくじょう	極上
こくしょく	黒色
こくじょく	国辱
こくじん	黒人
こくすい	国粋
こぐすり	粉薬
こくぜ	国是
こくせい	国勢
こくせい	国政
こくぜい	国税
こくせき	国籍
こくそ	告訴
こくそう	国葬
こくそう	穀倉
こくぞく	国賊
こくたい	国体
こくち	告知
こぐち	小口
こくてい	国定
こくてつ	国鉄
こくてん	黒点
こくでん	国電
こくど	国土
こくど	黒土
こくどう	国道
ごくどう	極道
こくない	国内
こくなん	国難
こくはく	告白
こくはく	酷薄
こくはつ	告発
こくばん	黒板
こくひ	国費
こくび	小首
ごくひ	極秘
こくびゃく	黒白
こくひょう	酷評
こくひん	国賓
こくふ	国府
こくふう	国風
こくふく	克復
こくふく	克服
こくぶん	国文
こくべつ	告別
こくほう	国宝
こくほう	国法
こくぼう	国防
ごくぼそ	極細
こくみん	国民
こくむ	国務
こくめい	克明
こくめい	刻銘
こくめい	国名
こくもつ	穀物
ごくもん	獄門
こくやく	国訳
こくゆ	告諭
こくゆう	国有
ごくらく	極楽
ごくり	獄吏
こくりつ	国立
こくりょく	国力
こくるい	穀類
こくれん	国連
こくろん	国論
こけ	こけ
こげ	焦げ
ごけ	後家
こけい	固形
ごけい	互恵
こけん	沽券
ごげん	語源
ここ	ここ
ここ	個々
こご	古語
ごご	午後
ここう	股肱
ごこう	後光
こごえ	小声
ここく	故国
ごこく	五穀
ごこく	護国
ここち	心地
こごめ	粉米
こごり	凝り
こころえ	心得
こころざす	志す
こころね	心根
こころみ	試み
こころよい	快い
ここん	古今
ごこん	語根
ごさ	誤差
ござ	ござ
ごさい	後妻
こさく	小作
こさめ	小雨
こざら	小皿
こさん	古参
ごさん	午餐
ごさん	誤算
こし	枯死
こじ	居士
こじ	古事
こじ	固持
こじ	固辞
こじ	孤児
こじ	故事
こじ	誇示
ごし	越し
ごし	五指
ごじ	誤字
こしかけ	腰掛
こしき	古式
こじき	乞食
ごしき	五色
こしつ	固執
こじつ	故実
ごじつ	後日
こしべん	腰弁
こしぼそ	腰細
こしまき	腰巻
こしゃく	小癪
こしゅ	固守
こしゅ	戸主
こしゆ	腰湯
こしゅう	固執
ごじゅう	五十
こしょ	古書
ごしょ	御所
ごじょ	互助
こしょう	呼称
こしょう	故障
こしょう	湖沼
こしょう	胡椒
こしょう	小姓
こじょう	古城
ごしょう	後生
ごじょう	互譲
ごしょく	誤植
こじり	湖尻
こしん	湖心
こじん	個人
こじん	古人
こじん	故人
ごしん	誤信
ごしん	誤審
ごしん	誤診
ごしん	護身
ごじん	吾人
こす	こす
こす	越す
こすい	湖水
こすい	鼓吹
ごすい	午睡
こすう	戸数
こずえ	木末
ごせ	後世
こせい	個性
ごせい	互生
ごせい	悟性
ごせい	語勢
こせき	古跡
こせき	戸籍
こぜに	小銭
ごせん	五千
ごせん	互選
ごぜん	午前
ごぜん	御前
こぞ	こぞ
こぞう	小僧
ごそう	護送
ごぞう	五臓
こそく	姑息
こそで	小袖
こたい	個体
こたい	固体
こだい	古代
こだい	誇大
ごたい	五体
こたえ	答え
こだから	子宝
こだち	木立
こたつ	炬燵
こだね	子種
こたん	枯淡
こち	故知
こち	故地
こち	東風
こちゃく	固着
こちょう	誇張
ごちょう	伍長
ごちょう	語調
こつ	こつ
こっか	国家
こっか	国歌
こっか	国花
こっかい	国会
こづかい	小使
こっかく	骨格
こっかん	酷寒
ごっかん	極寒
こっき	克己
こっき	国旗
こっきょう	国境
こっきん	国禁
こっけい	滑稽
こっけい	国警
こっけん	国憲
こっけん	国権
こっこ	国庫
こっこう	国交
こっこく	刻々
こっし	骨子
こつじき	乞食
こつずい	骨髄
こっせつ	骨折
こつぜん	忽然
こっとう	骨董
こつにく	骨肉
こつねん	忽然
こつばん	骨盤
こつぶ	小粒
こつまく	骨膜
こて	こて
こて	小手
ごて	後手
こてい	固定
こてん	個展
こてん	古典
ごてん	御殿
こと	古都
こと	糊塗
ごと	ごと
ことう	孤島
こどう	鼓動
ごとう	誤答
ことがら	事柄
こどく	孤独
ごとし	如し
ことば	言葉
こども	子供
ことわり	断り
こなぐすり	粉薬
こなゆき	粉雪
ごにち	後日
ごにん	誤認
この	この
このみ	好み
このむ	好む
こばな	小鼻
こばなし	小話
こはる	小春
こはん	湖畔
こばん	小判
ごはん	御飯
ごばん	碁盤
こび	媚び
ごび	語尾
こびと	小人
ごひゃく	五百
ごびゅう	誤謬
こぶ	こぶ
こぶ	鼓舞
ごふ	護符
こふう	古風
ごふく	呉服
こぶつ	古物
こぶね	小舟
こふん	古墳
こぶん	古文
こぶん	子分
ごふん	胡粉
ごへい	語弊
こべつ	個別
こべつ	戸別
ごほう	語法
ごほう	誤報
こぼく	古木
こほん	古本
こま	こま
ごま	ごま
こまあみ	細編
こまく	鼓膜
こまる	困る
こみ	込み
ごみ	ごみ
こみみ	小耳
こむ	こむ
こむ	込む
ごむ	ゴム
こむすび	小結
こめぐら	米倉
こめだわら	米俵
こめつぶ	米粒
こめぬか	米糠
こめや	米屋
ごめん	御免
こも	こも
ごもく	五目
こもの	小者
こもん	顧問
こや	小屋
ごや	後夜
こやく	子役
ごやく	誤訳
こやま	小山
こゆう	個有
こゆう	固有
こゆき	小雪
こゆき	粉雪
こゆび	小指
こよう	雇用
ごよう	御用
こら	こら
こらい	古来
ごらく	娯楽
ごらん	御覧
こり	凝り
こり	垢離
こりつ	孤立
こりょ	顧慮
ごりょう	御陵
ごりん	五輪
こる	凝る
これ	これ
ころ	ころ
ごろ	ゴロ
ごろ	語呂
ころう	固陋
ころう	故老
ごろく	五六
ころす	殺す
こわいい	強飯
こわいろ	声色
こわく	蠱惑
こわだか	声高
こわね	声音
こわめし	強飯
こん	こん
こんい	懇意
こんいん	婚姻
こんか	婚家
ごんか	言下
こんかい	今回
こんかん	根幹
こんがん	懇願
こんき	今期
こんき	婚期
こんき	根気
こんきゃく	困却
こんきゅう	困窮
こんきょ	根拠
こんぎょう	今暁
こんく	困苦
ごんげ	権化
こんけつ	混血
こんげつ	今月
ごんげん	権現
こんご	今後
ごんご	言語
こんこう	混淆
こんごう	混合
こんこん	昏々
こんこん	滾々
こんざい	混在
こんざつ	混雑
こんじ	今次
こんじ	恨事
こんじ	根治
こんじ	紺地
こんじき	金色
こんじゃく	今昔
こんしゅう	今秋
こんしゅう	今週
こんしゅん	今春
こんじょう	今生
こんじょう	根性
こんじょう	紺青
ごんじょう	言上
こんしょく	混食
こんしん	懇親
こんしん	混信
こんしん	渾身
こんすい	昏睡
こんせい	懇請
こんせい	混成
こんせい	混声
こんせき	今夕
こんせき	痕跡
こんせつ	懇切
こんぜつ	根絶
こんせん	混戦
こんせん	混線
こんぜん	渾然
こんだく	混濁
こんだて	献立
こんたん	魂胆
こんだん	懇談
こんち	根治
こんちゅう	昆虫
こんてい	根柢
こんでい	金泥
こんど	今度
こんとう	昏倒
こんどう	金堂
こんどう	混同
こんとく	懇篤
こんとん	渾沌
こんなん	困難
こんにち	今日
こんにゅう	混入
こんねん	今年
こんぱい	困憊
こんぱく	魂魄
こんばん	今晩
こんぱん	今般
こんぼう	混紡
こんぼう	棍棒
こんぽう	梱包
こんぽん	根本
こんめい	混迷
こんもう	懇望
こんや	今夜
こんやく	婚約
こんゆう	今夕
こんよう	混用
こんらん	混乱
こんりゅう	建立
こんれい	婚礼
こんろ	焜炉
こんわく	困惑
さ	−さ
さあ	さあ
さい	さい
さい	差異
さいあい	最愛
さいあく	最悪
ざいあく	罪悪
ざいい	在位
さいえん	再演
さいえん	才媛
さいえん	菜園
さいか	災禍
さいか	裁可
さいか	西下
ざいか	罪科
ざいか	財貨
さいかい	再会
さいかい	再開
さいかい	斎戒
さいがい	災害
ざいかい	財界
ざいがい	在外
さいかく	才覚
ざいがく	在学
さいかん	才幹
さいき	再起
さいき	才気
さいぎ	猜疑
さいきょ	再挙
ざいきょう	在京
ざいきょう	在郷
さいきん	最近
さいきん	細菌
ざいきん	在勤
さいく	細工
さいくつ	採掘
さいくん	細君
ざいけ	在家
さいけつ	採決
さいけつ	裁決
さいげつ	歳月
さいけん	債券
さいけん	債権
さいけん	再建
さいけん	再見
さいげん	再現
さいげん	際限
ざいげん	財源
さいご	最期
さいご	最後
ざいこ	在庫
さいこう	再興
さいこう	再考
さいこう	最高
さいこう	採光
さいこう	採鉱
ざいごう	在郷
ざいごう	罪業
さいごく	西国
さいこん	再建
さいこん	再婚
さいさき	幸先
さいさん	再三
さいさん	採算
ざいさん	財産
さいし	妻子
さいし	才子
さいし	祭祀
さいじ	細字
さいしき	彩色
さいじつ	祭日
さいしゅ	採取
さいしゅう	最終
さいしゅう	採集
ざいじゅう	在住
さいしゅつ	歳出
さいしょ	最初
さいじょ	才女
さいしょう	最少
さいしょう	宰相
さいじょう	最上
さいじょう	斎場
ざいしょう	罪障
ざいじょう	罪状
さいしょく	菜食
ざいしょく	在職
さいしん	再審
さいしん	最新
さいしん	細心
さいじん	才人
さいせい	再生
ざいせい	在世
ざいせい	財政
さいせき	採石
さいせん	再選
さいせん	賽銭
さいぜん	最前
さいぜん	最善
さいそう	採草
さいそく	催促
さいそく	細則
さいたい	妻帯
さいだい	最大
さいだい	細大
ざいたい	在隊
さいたく	採択
ざいたく	在宅
さいたん	最短
さいたん	採炭
さいだん	祭壇
さいだん	裁断
ざいだん	財団
さいち	才知
さいちゅう	最中
ざいちゅう	在中
さいてい	最低
さいてい	裁定
さいてき	最適
さいてん	採点
さいてん	祭典
ざいてん	在天
さいど	再度
さいど	彩度
さいど	済度
さいどく	再読
さいなん	災難
さいにゅう	歳入
さいにん	再任
ざいにん	在任
ざいにん	罪人
さいねん	再燃
さいのう	才能
さいはい	釆配
さいばい	栽培
さいはつ	再発
ざいばつ	財閥
さいはん	再版
さいはん	再犯
さいばん	裁判
さいひ	採否
さいひ	歳費
さいふ	財布
さいぶ	細部
さいぼ	歳暮
さいほう	裁縫
さいほう	西方
さいぼう	細胞
ざいほう	財宝
さいまつ	歳末
さいみつ	細密
さいみん	催眠
さいむ	債務
ざいむ	財務
ざいめい	罪名
さいもく	細目
ざいもく	材木
ざいや	在野
さいやく	災厄
さいよう	採用
さいらい	再来
ざいらい	在来
さいりゃく	才略
ざいりゅう	在留
さいりょう	最良
さいりょう	裁量
ざいりょう	材料
ざいりょく	財力
さいれい	祭礼
さいろく	採録
さいわん	才腕
ざう	座右
さえつ	査閲
さおだけ	竿竹
さか	茶菓
さかえ	栄え
さがく	差額
さかさ	逆さ
さがす	探す
さかて	逆手
さかて	酒手
さかなみ	逆波
さかなや	魚屋
さかば	酒場
さかみち	坂道
さかや	酒屋
さかゆめ	逆夢
さかり	盛り
さかん	左官
さがん	左岸
さき	さき
さき	左記
さぎ	さぎ
さぎ	詐欺
さきざき	先々
さきぶと	先太
さきぼそ	先細
さきもの	先物
さきゅう	砂丘
さぎょう	作業
ざきょう	座興
さきん	砂金
さく	咲く
さく	裂く
さくい	作意
さくい	作為
さくいん	作因
さくいん	索引
さくおう	策応
さくおとこ	作男
さくがら	作柄
さくき	数寄
さくげん	削減
さくご	錯誤
さくざつ	錯雑
さくさん	醋酸
さくし	作詞
さくし	策士
さくじつ	昨日
さくしゃ	作者
さくしゅ	搾取
さくじょ	削除
さくず	作図
さくせい	作成
さくせい	作製
さくせん	作戦
さくぜん	索然
さくそう	錯綜
さくちゅう	作中
さくてき	索敵
さくどう	策動
さくねん	昨年
さくばん	昨晩
さくひん	作品
さくふう	作風
さくぶん	作文
さくぼう	策謀
さくもつ	作物
さくや	昨夜
さくよう	〓葉
さくらいろ	桜色
さくらもち	桜餅
さくらん	錯乱
さぐり	探り
さくりゃく	策略
さぐる	探る
さくれつ	炸裂
さけ	さけ
さげ	下げ
さけい	左傾
さけび	叫び
さけぶ	叫ぶ
さげん	左舷
ざこ	ざこ
ざこう	坐高
さこく	鎖国
さこつ	鎖骨
ざこつ	坐骨
ささ	ささ
ささい	些細
ささえ	支え
ささつ	査察
ささぶね	笹舟
ささやぶ	笹薮
さし	刺し
さじ	さじ
さじ	瑣事
ざし	坐視
さしえ	挿絵
さじき	桟敷
ざしき	座敷
さしず	指図
さしゃ	左社
さしゅ	詐取
さしゅう	査収
さしょう	些少
さしょう	査証
さしょう	詐称
ざしょう	坐礁
ざしょく	坐食
さす	さす
さす	刺す
さす	指す
さす	射す
ざせき	座席
ざせつ	挫折
させん	左遷
ざぜん	座禅
さぞ	さぞ
さそい	誘い
さそう	誘う
さそく	左側
さた	沙汰
さだめ	定め
ざだん	座談
ざちょう	座長
さつい	殺意
さつえい	撮影
ざつえき	雑役
ざつおん	雑音
さっか	作家
ざっか	雑貨
さつがい	殺害
さっかく	錯覚
さっかく	錯角
ざっかん	雑感
さっき	殺気
さっき	数奇
ざっき	雑記
さっきゅう	遡及
さっきゅう	早急
ざっきょ	雑居
さっきょく	作曲
さっきん	殺菌
ざっこく	雑穀
さっこん	昨今
ざっこん	雑婚
さっし	冊子
さっし	察し
ざっし	雑誌
ざつじ	雑事
ざっしゅ	雑種
さっしょう	殺傷
ざっしょく	雑食
さっしん	刷新
さつじん	殺人
さつじん	殺陣
ざつぜん	雑然
さっそう	颯爽
ざっそう	雑草
さっそく	早速
ざった	雑多
さつたば	札束
ざつだん	雑談
さっち	察知
さっとう	殺到
ざっとう	雑踏
ざつねん	雑念
ざっぱく	雑駁
さつばつ	殺伐
ざっぴ	雑費
ざつぶつ	雑物
ざつぶん	雑文
ざっぽう	雑報
ざつむ	雑務
ざつよう	雑用
さつりく	殺戮
ざつろく	雑録
さて	さて
さてい	査定
さてつ	砂鉄
さてつ	蹉跌
さと	さと
さとい	敏い
さとう	差等
さとう	砂糖
さどう	茶道
ざとう	座頭
さとおや	里親
さとかた	里方
さとご	里子
さとごころ	里心
さとり	悟り
さとる	悟る
さなえ	早苗
さは	左派
さば	さば
さはい	差配
さばく	砂漠
さばく	裁く
さび	寂び
ざひょう	座標
さべつ	差別
さぼ	サボ
さほう	左方
さほう	作法
ざま	ざま
さまざま	様々
さまたげ	妨げ
さまつ	瑣末
さむい	寒い
さむけ	寒気
さむざむ	寒々
さむぞら	寒空
さめ	さめ
さも	さも
さもん	査問
さや	さや
さゆ	白湯
さゆう	左右
ざゆう	座右
さよう	作用
さよく	左翼
さら	さら
ざら	ざら
さらさ	更紗
さらに	更に
さる	さる
さる	去る
ざる	ざる
さるどし	申年
さるまた	猿又
さわ	茶話
さわぎ	騒ぎ
さわぐ	騒ぐ
さわり	障り
さん	さん
さんい	賛意
さんいつ	散佚
さんいん	参院
さんいん	山陰
さんか	傘下
さんか	参加
さんか	山河
さんか	山窩
さんか	惨禍
さんか	産科
さんか	讃歌
さんか	酸化
さんが	参賀
さんが	山河
さんかい	参会
さんかい	山海
さんかい	散会
さんかい	散開
さんがい	三界
さんがい	惨害
さんかく	三角
さんかく	参画
さんがく	山岳
さんがく	産額
ざんがく	残額
さんかん	参観
さんかん	山間
さんき	山気
さんぎ	参議
ざんき	慚愧
ざんぎく	残菊
さんきゃく	三脚
ざんぎゃく	残虐
さんぎょう	産業
さんぎょう	讃仰
ざんぎょう	残業
ざんきん	残金
さんぐう	参宮
ざんげ	懺悔
さんけい	参詣
さんけい	山系
さんげき	惨劇
ざんげつ	残月
さんけん	散見
ざんげん	讒言
さんご	産後
さんこう	三更
さんこう	参考
ざんごう	塹壕
ざんこく	残酷
さんさ	三叉
さんさい	三才
さんざい	散在
さんざい	散財
ざんさい	残滓
さんさく	散策
ざんさつ	惨殺
さんさん	燦々
さんざん	散々
さんし	三四
さんし	蚕糸
さんじ	参事
さんじ	産児
さんじ	讃辞
ざんし	残滓
ざんじ	暫時
さんしつ	蚕室
さんしゃく	参酌
さんしゅう	参集
さんじゅう	三十
さんしゅつ	産出
さんしゅつ	算出
さんじゅつ	算術
さんじょ	賛助
ざんしょ	残暑
さんしょう	参照
さんじょう	参上
さんじょう	山上
さんじょう	惨状
さんしょく	蚕食
さんしん	三振
ざんしん	斬新
さんすい	山水
さんすい	散水
さんすう	算数
さんすけ	三助
さんせい	三正
さんせい	賛成
さんせい	酸性
さんせき	山積
ざんせつ	残雪
さんせん	参戦
さんせん	山川
さんぜん	三千
さんぜん	産前
さんぜん	潸然
さんそ	酸素
さんそう	山荘
さんぞく	山賊
さんそん	山村
ざんそん	残存
さんたい	三体
さんだい	参内
ざんだか	残高
さんだつ	纂奪
さんたん	惨澹
さんたん	讃嘆
さんだん	算段
さんち	山地
さんち	産地
さんちゅう	山中
さんちょう	山頂
さんてい	算定
ざんてい	暫定
さんてつ	三哲
さんてん	山巓
さんどう	参道
さんどう	賛同
さんにゅう	算入
ざんにん	残忍
ざんねん	残念
さんば	産婆
さんぱい	参拝
ざんぱい	惨敗
さんばし	桟橋
さんぱつ	散発
さんぱつ	散髪
ざんぱん	残飯
さんび	讃美
さんび	賛美
さんぴ	賛否
さんびゃく	三百
さんぴょう	散票
ざんぴん	残品
さんぷ	散布
さんぷ	産婦
ざんぶ	残部
さんぷく	山腹
さんぶつ	産物
さんぶん	三分
さんぶん	散文
さんぽ	散歩
さんぼう	三宝
さんぼう	参謀
さんぼう	山房
さんまい	三昧
さんまん	散漫
さんみ	酸味
さんみゃく	山脈
ざんむ	残務
さんもん	山門
さんや	山野
さんやく	散薬
さんよ	参与
ざんよ	残余
さんよう	山陽
さんよう	算用
さんらん	散乱
さんらん	燦爛
さんらん	産卵
ざんりゅう	残留
さんりん	山林
さんるい	三塁
さんれつ	参列
さんろく	山麓
しあい	試合
じあい	慈愛
じあい	自愛
しあん	思案
しあん	私案
しあん	試案
しい	しい
しい	四囲
しい	私意
じい	じい
じい	侍医
じい	示威
じい	自慰
じい	辞意
しいか	詩歌
しいく	飼育
じいと	地糸
しいん	子音
しいん	死因
じいん	寺院
じう	慈雨
しえい	市営
じえい	自営
じえい	自衛
しえき	使役
しえん	支援
しえん	私怨
しおかぜ	潮風
しおから	塩辛
しおけ	塩気
しおざけ	塩鮭
しおじ	潮路
しおひ	潮干
しおみず	塩水
しおん	子音
しおん	師恩
じおん	字音
しか	しか
しか	史家
しか	市価
しか	賜暇
しか	歯科
しが	歯牙
じか	時価
じか	自家
じか	自火
じが	自我
しかい	司会
しかい	四界
しかい	市会
しかい	死海
しかい	視界
しがい	市外
しがい	市街
しがい	死骸
じかい	次回
じかい	自戒
じがい	自害
しかく	四角
しかく	死角
しかく	視覚
しかく	視角
しかく	資格
しがく	史学
しがく	私学
じかく	字画
じかく	自覚
しかた	仕方
じかた	地方
しかつ	死活
じかつ	自活
じがね	地金
しかり	叱り
しかん	士官
しかん	弛緩
しがん	志願
じかん	時間
じかん	次官
しき	四季
しき	士気
しき	指揮
しき	死期
しき	敷き
じき	じき
じき	時期
じき	時機
じき	磁器
じき	磁気
じき	自棄
じき	自記
じぎ	時宜
しきい	敷居
しききん	敷金
しきけん	識見
しきさい	色彩
しきし	色紙
しきじ	式辞
しきしゃ	識者
しきじゃく	色弱
しきじょう	式場
しきじょう	色情
しきそ	色素
じきそ	直訴
しきそう	色相
しきだい	式台
しきち	敷地
しきちょう	色調
しきてん	式典
じきでん	直伝
じきひつ	直筆
しきふ	敷布
しきふく	式服
しきべつ	識別
しきもう	色盲
しきゅう	四球
しきゅう	子宮
しきゅう	支給
しきゅう	至急
じきゅう	持久
じきゅう	自給
しきょ	死去
じきょ	辞去
しきょう	市況
しきょう	詩興
しきょう	示教
しぎょう	始業
じきょう	自供
じぎょう	事業
しきょく	支局
しきよく	色欲
じきょく	時局
じきわ	直話
しきん	至近
しきん	資金
しぎん	市銀
しぎん	詩吟
しく	しく
しく	敷く
じく	字句
じぐち	地口
しくつ	試掘
しぐれ	時雨
じくん	字訓
しけ	しけ
しけい	死刑
しけい	私刑
しけい	紙型
しけい	詩型
しげい	繁い
じけい	字形
じけい	次兄
しげき	刺激
しけつ	止血
じけつ	自決
しげみ	茂み
しげる	茂る
しけん	私見
しけん	試験
しげん	至言
しげん	資源
じけん	事件
じげん	時限
じげん	次元
しご	四五
しご	死後
しご	死語
しご	私語
じこ	事故
じこ	自己
じご	事後
じご	爾後
しこう	伺候
しこう	志向
しこう	思考
しこう	指向
しこう	施行
しこう	私行
しこう	試行
しこう	嗜好
じこう	事項
じこう	時候
じこう	時効
じこう	時好
じごう	次号
じごえ	地声
しこく	四国
しごく	至極
じこく	時刻
じこく	自国
じごく	地獄
しごと	仕事
しさ	示唆
じさ	時差
しさい	仔細
しざい	死罪
しざい	私財
しざい	資材
じざい	自在
しさく	思索
しさく	施策
しさく	試作
じさく	自作
しさつ	視察
じさつ	自殺
しさん	四散
しさん	資産
しざん	死産
じさん	持参
しし	しし
しし	嗣子
しし	四肢
しし	志士
しし	孜々
しじ	師事
しじ	指示
しじ	支持
しじ	私事
じし	侍史
じじ	じじ
じじ	時事
ししつ	紙質
ししつ	資質
しじつ	史実
じしつ	自失
じじつ	事実
じじつ	時日
ししゃ	使者
ししゃ	支社
ししゃ	死者
ししゃ	試写
ししゃ	試射
じしゃ	寺社
ししゃく	子爵
じしゃく	磁石
じじゃく	自若
ししゅ	死守
ししゅ	詩趣
じしゅ	自主
じしゅ	自首
ししゅう	刺繍
ししゅう	詩集
しじゅう	四十
しじゅう	始終
じしゅう	自習
じじゅう	侍従
ししゅく	止宿
ししゅく	私淑
しじゅく	私塾
じしゅく	自粛
ししゅつ	支出
ししゅん	思春
しじゅん	諮詢
ししょ	司書
ししょ	支所
しじょ	子女
じしょ	字書
じしょ	辞書
じしょ	地所
じじょ	侍女
じじょ	次女
ししょう	師匠
ししょう	支障
ししょう	死傷
しじょう	市場
しじょう	私情
しじょう	紙上
しじょう	至上
しじょう	至情
しじょう	詩情
じしょう	事象
じしょう	自称
じじょう	事情
じじょう	磁場
じじょう	自乗
ししょく	紫色
ししょく	試食
じしょく	辞職
ししん	指針
ししん	私信
ししん	私心
しじん	私人
しじん	詩人
じしん	時針
じしん	磁針
じしん	自信
じしん	自身
じしん	地震
じすい	自炊
しすう	指数
しすう	紙数
しずか	静か
しずしず	静々
しずみ	沈み
しずむ	沈む
しずめ	静め
しせい	姿勢
しせい	市井
しせい	市制
しせい	市勢
しせい	市政
しせい	施政
しせい	死生
しせい	私製
しせい	至誠
しせい	資性
じせい	時世
じせい	時勢
じせい	自省
じせい	自制
じせい	自製
じせい	辞世
しせき	史跡
じせき	事績
じせき	次席
じせき	自責
しせつ	使節
しせつ	施設
しせつ	私設
じせつ	時節
じせつ	自説
しせん	支線
しせん	死線
しせん	視線
しぜん	自然
じせん	自薦
じせん	自選
じぜん	事前
じぜん	慈善
じぜん	次善
しそ	しそ
しそ	始祖
しそう	使嗾
しそう	思想
しそう	死相
しぞう	死蔵
じぞう	地蔵
しそく	子息
しぞく	士族
しぞく	氏族
じそく	時速
じそく	自足
じぞく	持続
しそん	子孫
じそん	自尊
しだ	しだ
じた	自他
したい	姿態
したい	死体
したい	肢体
しだい	四大
しだい	次第
じたい	事態
じたい	字体
じたい	自体
じたい	辞退
じだい	時代
じだい	地代
したう	慕う
したえ	下絵
したがう	従う
したがわ	下側
したぎ	下着
したく	仕度
したく	私宅
じたく	自宅
したごころ	下心
したさき	舌先
したじ	下地
しただい	舌代
したたり	滴り
したつづみ	舌鼓
したて	下手
したはら	下腹
したび	下火
したまえ	下前
したまち	下町
したみ	下見
したやく	下役
しだん	師団
じだん	示談
しち	死地
じち	自治
しちじゅう	七十
しちはち	七八
しちや	質屋
しちゅう	市中
しちゅう	支柱
しちょう	市長
しちょう	思潮
しちょう	視聴
しちょう	試聴
しちよう	七曜
じちょう	次長
じちょう	自重
じちょう	自嘲
しちりん	七輪
じちん	自沈
しつい	失意
じつい	実意
じついん	実印
しつう	私通
じつえん	実演
しっか	失火
じっか	実家
しつがい	室外
しっかく	失格
しっかん	疾患
じっかん	実感
しっき	湿気
しっき	漆器
しつぎ	質疑
しっきゃく	失脚
しつぎょう	失業
じっきょう	実況
じつぎょう	実業
しっく	疾駆
しっけ	湿気
しっけい	失敬
じっけい	実兄
じっけい	実景
じつげつ	日月
しつげん	失言
じっけん	実権
じっけん	実見
じっけん	実験
じつげん	実現
しっこう	執行
しっこう	失効
じっこう	実効
じっこう	実行
しっこく	漆黒
しっこく	桎梏
じっさい	実際
じつざい	実在
しっさく	失策
しっし	嫉視
じっし	実子
じっし	実施
しつじつ	質実
じっしつ	実質
じっしゅう	実収
じっしゅう	実習
しつじゅん	湿潤
しっしょう	失笑
じっしょう	実証
じつじょう	実情
しっしょく	失職
しっしん	失神
しっしん	湿疹
じっすう	実数
しっせい	失政
しっせき	叱責
しっせき	失跡
じっせき	実績
じっせん	実戦
じっせん	実線
じっせん	実践
しっそ	質素
しっそう	失踪
しっそう	疾走
じっそう	実相
しっそく	失速
じっそく	実測
じつぞん	実存
しった	叱〓
しったい	失態
じったい	実体
じったい	実態
じつだん	実弾
しっち	失地
しっち	湿地
じっち	実地
しっちょう	失調
じっちょく	実直
しっつい	失墜
じってい	実弟
しっと	嫉妬
しつど	湿度
しっとう	執刀
しつない	室内
じつに	実に
しつねん	失念
じつは	実は
しっぱい	失敗
しっぴ	櫛比
じっぴ	実否
じっぴ	実費
しっぴつ	執筆
しっぷ	湿布
じっぷ	実父
しっぷう	疾風
じつぶつ	実物
しっぺい	疾病
じつぼ	実母
しっぽう	七宝
しつぼう	失望
しつぼく	質朴
しつむ	執務
じつむ	実務
しつめい	失明
しつもん	質問
しつよう	執拗
じつよう	実用
じづら	字面
じつり	実利
しつりょう	質量
じつりょく	実力
しつれい	失礼
じつれい	実例
しつれん	失恋
じつろく	実録
じつわ	実話
して	シテ
して	仕手
してい	子弟
してい	師弟
してい	指定
してい	私邸
してき	指摘
してき	私的
じてき	自適
してつ	私鉄
してん	支店
してん	支点
してん	視点
しでん	市電
じてん	事典
じてん	字典
じてん	時点
じてん	次点
じてん	自転
じてん	辞典
じでん	自伝
しと	使徒
しと	使途
しとう	死闘
しとう	至当
しどう	始動
しどう	指導
じとう	地頭
じどう	児童
じどう	自動
じとく	自得
じとく	自涜
しな	しな
しない	市内
しない	竹刀
しなじな	品々
しなもの	品物
しなん	指南
しなん	至難
じなん	次男
しにがみ	死神
しにん	死人
じにん	自任
じにん	自認
じにん	辞任
しぬ	死ぬ
じぬし	地主
じねつ	地熱
じねん	自然
しの	しの
しのび	忍び
しのぶ	偲ぶ
しのぶ	忍ぶ
しば	しば
じば	磁場
しはい	支配
しばい	芝居
じはく	自白
じばく	自爆
じばく	自縛
しはつ	始発
じはつ	自発
しばふ	芝生
じばら	自腹
しはん	四半
しはん	市販
しはん	師範
じばん	地盤
しひ	私費
じひ	慈悲
じひ	自費
じび	耳鼻
しひつ	試筆
じひつ	自筆
しびと	死人
しひょう	師表
しひょう	指標
じひょう	時評
じひょう	辞表
じびょう	持病
しふ	師父
しぶ	支部
じふ	慈父
じふ	自負
しぶい	渋い
しぶかわ	渋皮
しふく	私服
しふく	私腹
しふく	雌伏
しぶしぶ	渋々
しぶつ	死物
しぶつ	私物
じぶつ	事物
しぶみ	渋味
しぶる	渋る
しふん	私憤
じぶん	時分
じぶん	時文
じぶん	自分
しへい	紙幣
しべつ	死別
しへん	四辺
しへん	紙片
しべん	支弁
じへん	事変
じべん	自弁
しぼ	思慕
じぼ	慈母
しほう	司法
しほう	四方
しほう	至宝
しぼう	志望
しぼう	死亡
しぼう	脂肪
じほう	時報
しぼつ	死没
しぼり	絞り
しほん	資本
しまい	姉妹
じまく	字幕
しまぐに	島国
しまだ	島田
しまつ	始末
じまん	自慢
しみ	しみ
じみ	じみ
じみ	滋味
しみず	清水
じみち	地道
しみん	士民
しみん	市民
しみん	嗜眠
じみん	自民
じむ	事務
しめ	しめ
しめい	使命
しめい	指名
しめい	死命
しめい	氏名
じめい	自明
しめし	示し
しめし	湿し
しめす	示す
しめつ	死滅
じめつ	自滅
しめり	湿り
しめん	四面
しめん	紙面
じめん	字面
じめん	地面
しもき	下期
じもく	耳目
しもざ	下座
しもじも	下々
しもて	下手
じもと	地元
しもばしら	霜柱
しもん	指紋
しもん	試問
しもん	諮問
じもん	自問
しや	視野
じゃあく	邪悪
しゃい	謝意
しゃいん	社員
じゃいん	邪淫
しゃおん	謝恩
しゃか	釈迦
しゃかい	社会
しゃがい	社外
じゃき	邪気
じゃきょう	邪教
しやく	試薬
じやく	持薬
しゃくざい	借財
しゃくし	杓子
じゃくし	弱視
じゃくしゃ	弱者
しゃくしゃく	綽々
じゃくしょう	弱小
じゃくしん	弱震
しゃくせん	借銭
しゃくぜん	釈然
じゃくそつ	弱卒
しゃくそん	釈尊
じゃくたい	弱体
しゃくち	借地
じゃぐち	蛇口
じゃくてん	弱点
しゃくど	尺度
しゃくどう	赤銅
しゃくねつ	灼熱
じゃくねん	弱年
じゃくはい	若輩
しゃくはち	尺八
しゃくほう	釈放
しゃくめい	釈明
しゃくもん	借問
しゃくや	借家
しゃくよう	借用
しゃくらん	借覧
しゃくりょう	酌量
しゃげき	射撃
じゃけん	邪慳
しゃこ	車庫
しゃこう	社交
しゃこう	車行
しゃこう	遮光
しゃさい	社債
しゃざい	謝罪
しゃさつ	射殺
しゃし	斜視
しゃし	奢侈
しゃじ	写字
しゃじ	社寺
しゃじ	謝辞
しゃじく	車軸
しゃじつ	写実
しゃしょう	捨象
しゃしょう	車掌
しゃじょう	車上
しゃしん	写真
じゃすい	邪推
しゃせい	写生
しゃせつ	社説
しゃぜつ	謝絶
じゃせつ	邪説
しゃせん	斜線
しゃたい	車体
しゃたく	社宅
しゃだつ	洒脱
しゃだん	遮断
しゃちゅう	車中
しゃちょう	社長
しゃっか	借家
じゃっか	弱化
しゃっかん	借款
じゃっかん	若冠
じゃっかん	若干
じゃっかん	弱冠
じゃっき	惹起
しゃっきん	借金
しゃてい	射程
しゃてき	射的
しゃでん	社殿
しゃどう	車道
じゃどう	邪道
しゃない	社内
しゃない	車内
じゃねん	邪念
しゃば	車馬
しゃば	娑婆
じゃばら	蛇腹
しゃはん	這般
しゃふつ	煮沸
しゃへい	遮蔽
しゃべつ	差別
しゃへん	斜辺
しゃほん	写本
じゃま	邪魔
しゃめん	赦免
しゃめん	斜面
しゃもん	沙門
しゃもん	借問
しゃよう	斜陽
しゃよう	社用
しゃらく	洒落
じゃり	砂利
しゃりょう	車両
しゃりん	車輪
しゃれい	謝礼
しゅい	趣意
しゅい	首位
しゆう	師友
しゆう	私有
しゆう	雌雄
じゆう	事由
じゆう	自由
しゅうあく	醜悪
じゅうあつ	重圧
しゅうい	周囲
じゅうい	獣医
じゅうい	重囲
しゅういつ	秀逸
しゅういん	衆院
しゅうえき	収益
しゅうえん	終演
しゅうえん	終焉
じゅうおう	縦横
しゅうか	秀歌
しゅうか	衆寡
しゅうか	集荷
じゅうか	銃火
しゅうかい	集会
しゅうかく	収穫
しゅうがく	就学
しゅうがく	修学
しゅうかん	習慣
しゅうかん	週刊
しゅうかん	週間
じゅうかん	縦観
じゅうかん	縦貫
しゅうき	周忌
しゅうき	周期
しゅうき	秋季
しゅうき	臭気
しゅうぎ	衆議
しゅうぎ	祝儀
じゅうき	什器
しゅうきゅう	蹴球
しゅうきゅう	週休
しゅうきゅう	週給
じゅうきょ	住居
しゅうきょう	宗教
しゅうぎょう	就業
しゅうぎょう	修業
しゅうぎょう	修行
しゅうぎょう	終業
しゅうぎょう	醜業
じゅうぎょう	従業
しゅうきょく	終極
しゅうきん	集金
しゅうぐ	衆愚
じゅうぐん	従軍
しゅうけい	集計
じゅうけい	重刑
しゅうげき	襲撃
しゅうけつ	終結
しゅうけつ	集結
じゅうけつ	充血
しゅうけん	集権
しゅうげん	祝言
じゅうけん	銃剣
じゅうご	銃後
しゅうこう	周航
しゅうこう	就航
しゅうこう	修好
しゅうごう	集合
じゅうこう	重厚
じゅうこう	銃口
しゅうさい	秀才
じゅうざい	重罪
しゅうさく	習作
じゅうさつ	銃殺
しゅうさん	集散
しゅうし	収支
しゅうし	宗旨
しゅうし	終始
しゅうし	終止
しゅうじ	修辞
しゅうじ	習字
じゅうし	重視
じゅうじ	住持
じゅうじ	十字
じゅうじ	従事
しゅうじつ	終日
しゅうじつ	週日
じゅうじつ	充実
じゅうしゃ	従者
しゅうじゃく	執着
しゅうしゅう	収拾
しゅうしゅう	収集
しゅうじゅう	主従
じゅうじゅう	重々
しゅうしゅく	収縮
しゅうじゅく	習熟
じゅうじゅん	従順
じゅうじゅん	柔順
じゅうしょ	住所
しゅうしょう	周章
しゅうしょう	就床
しゅうしょう	愁傷
じゅうしょう	重傷
じゅうしょう	重唱
じゅうしょう	重症
しゅうしょく	就職
しゅうしょく	修飾
しゅうしょく	秋色
じゅうしょく	住職
しゅうしん	執心
しゅうしん	就寝
しゅうしん	修身
しゅうしん	終身
しゅうじん	囚人
じゅうしん	重心
じゅうしん	重臣
じゅうすい	重水
しゅうせい	修正
しゅうせい	終世
しゅうせい	終生
しゅうせい	習性
しゅうせい	集成
じゅうせい	銃声
じゅうぜい	重税
しゅうせき	集積
じゅうせき	重責
しゅうせん	周旋
しゅうせん	終戦
しゅうぜん	修繕
じゅうぜん	従前
しゅうそ	宗祖
じゅうそう	縦走
じゅうそう	重曹
しゅうそく	収束
しゅうそく	終熄
しゅうぞく	習俗
じゅうそく	充足
じゅうぞく	従属
じゅうそつ	従卒
しゅうたい	醜態
じゅうたい	渋滞
じゅうたい	縦隊
じゅうたい	重態
じゅうだい	重大
じゅうたく	住宅
しゅうだつ	収奪
しゅうたん	愁嘆
しゅうだん	集団
じゅうたん	絨毯
じゅうだん	縦断
しゅうち	周知
しゅうち	衆知
しゅうち	羞恥
しゅうちゃく	執着
しゅうちゅう	集中
しゅうちゅう	集注
しゅうちょう	酋長
じゅうちん	重鎮
じゅうてい	従弟
しゅうてん	終点
じゅうてん	充填
じゅうてん	重点
じゅうでん	充電
しゅうと	宗徒
しゅうとう	周到
じゅうとう	充当
じゅうどう	柔道
しゅうとく	拾得
しゅうとく	習得
じゅうなん	柔軟
しゅうにゅう	収入
しゅうにん	就任
じゅうにん	住人
じゅうにん	重任
しゅうねん	執念
しゅうねん	周年
しゅうのう	収納
じゅうのう	十能
しゅうは	周波
しゅうは	宗派
しゅうはい	集配
しゅうばく	就縛
じゅうばこ	重箱
しゅうはつ	終発
しゅうばん	週番
じゅうはん	従犯
じゅうはん	重版
じゅうびょう	重病
しゅうふう	秋風
じゅうふく	重複
しゅうぶん	秋分
しゅうぶん	醜聞
じゅうぶん	十分
しゅうへき	習癖
しゅうへん	周辺
しゅうほう	週報
しゅうぼう	衆望
しゅうまい	焼売
しゅうまく	終幕
しゅうまつ	終末
しゅうまつ	週末
じゅうまん	充満
じゅうまん	十万
しゅうみん	就眠
じゅうみん	住民
しゅうめい	主命
しゅうめい	襲名
しゅうもく	衆目
しゅうや	終夜
しゅうやく	集約
じゅうやく	重役
じゅうゆ	重油
しゅうゆう	周遊
しゅうよう	収容
しゅうよう	収用
しゅうよう	修養
じゅうよう	重要
しゅうらい	襲来
じゅうらい	従来
しゅうらく	集落
しゅうり	修理
しゅうりょう	収量
しゅうりょう	修了
しゅうりょう	終了
じゅうりょう	十両
じゅうりょう	重量
じゅうりょう	銃猟
じゅうりょく	重力
しゅうれい	秀麗
しゅうれい	秋冷
しゅうれん	修練
しゅうれん	習練
しゅうろく	収録
しゅうろく	集録
しゅうわい	収賄
しゅえい	守衛
じゅえき	受益
しゅえん	主演
しゅえん	酒宴
しゅおん	主恩
しゅか	主家
じゅか	樹下
しゅかい	首魁
しゅかく	主格
しゅかく	主客
じゅがく	儒学
しゅかん	主幹
しゅかん	主管
しゅかん	主観
しゅがん	主眼
しゅき	手記
しゅき	酒気
しゅぎ	主義
しゅきゃく	主客
しゅきゅう	首級
じゅきゅう	需給
しゅぎょう	修業
しゅぎょう	修行
じゅきょう	儒教
じゅぎょう	授業
しゅぎょく	珠玉
しゅくい	祝意
じゅくいん	塾員
しゅくえい	宿営
しゅくえん	祝宴
しゅくが	祝賀
しゅくがん	宿願
じゅくご	熟語
しゅくさつ	縮刷
しゅくし	宿志
しゅくじ	祝辞
じゅくし	熟柿
じゅくし	熟視
しゅくじつ	祝日
しゅくしゃ	宿舎
しゅくしゃ	縮写
しゅくしゃく	縮尺
しゅくしゅく	粛々
しゅくじょ	淑女
しゅくしょう	縮小
しゅくず	縮図
じゅくすい	熟睡
しゅくせい	粛正
しゅくせい	粛清
しゅくぜん	粛然
しゅくだい	宿題
じゅくたつ	熟達
じゅくち	熟知
しゅくちょく	宿直
しゅくてん	祝典
しゅくでん	祝電
しゅくとく	淑徳
じゅくどく	熟読
しゅくば	宿場
しゅくはい	祝杯
しゅくはく	宿泊
しゅくふく	祝福
しゅくほう	祝砲
しゅくぼう	宿望
じゅくみん	熟眠
しゅくめい	宿命
じゅくりょ	熟慮
じゅくれん	熟練
しゅくん	主君
しゅくん	殊勲
しゅけい	主計
しゅげい	手芸
じゅけい	受刑
しゅけん	主権
じゅけん	受検
じゅけん	受験
しゅご	主語
しゅご	守護
しゅこう	手交
しゅこう	手工
しゅこう	趣向
しゅこう	首肯
しゅさ	主査
しゅさい	主催
しゅさい	主宰
しゅざい	取材
しゅざん	珠算
じゅさん	授産
しゅし	主旨
しゅし	種子
しゅし	趣旨
しゅじ	主治
じゅし	樹脂
しゅしゃ	取捨
じゅしゃ	儒者
しゅじゅ	種々
じゅじゅ	授受
しゅじゅう	主従
しゅじゅつ	手術
しゅしょう	主唱
しゅしょう	主将
しゅしょう	殊勝
しゅしょう	首唱
しゅしょう	首相
しゅじょう	衆生
じゅしょう	受賞
じゅしょう	授賞
じゅじょう	樹上
しゅしょく	主食
しゅしょく	酒食
しゅしん	主審
しゅじん	主人
じゅしん	受信
じゅしん	受診
しゅす	繻子
じゅず	数珠
しゅせい	守勢
しゅせい	酒精
じゅせい	受精
じゅせい	授精
しゅせき	主席
しゅせき	手跡
しゅせき	首席
じゅせき	樹石
しゅせん	酒仙
じゅそ	呪詛
しゅぞう	酒造
しゅそく	手足
しゅぞく	種族
しゅたい	主体
しゅだい	主題
じゅたい	受胎
じゅたく	受託
じゅだく	受諾
しゅだん	手段
しゅちく	種畜
じゅちゅう	受注
しゅちょう	主張
しゅちょう	首長
しゅつえん	出演
しゅっか	出火
しゅっか	出荷
じゅっかい	述懐
しゅっかん	出棺
しゅつがん	出願
しゅつぎょ	出漁
しゅっきん	出勤
しゅっけ	出家
しゅっけつ	出欠
しゅっけつ	出血
しゅつげん	出現
じゅつご	術語
じゅつご	述語
しゅっこう	出港
しゅっこう	出講
じゅっこう	熟考
しゅつごく	出獄
じゅっさく	術策
しゅっさつ	出札
しゅっさん	出産
しゅっし	出仕
しゅっし	出資
しゅっしゃ	出社
しゅっしょ	出所
しゅっしょう	出生
しゅつじょう	出場
しゅっしょく	出色
しゅっしん	出身
しゅつじん	出陣
しゅっすい	出水
しゅっせ	出世
しゅっせい	出征
しゅっせい	出生
しゅっせき	出席
しゅっせん	出船
しゅったい	出来
しゅつだい	出題
しゅったつ	出立
しゅったん	出炭
しゅっちょう	出張
しゅっちょう	出超
しゅっちん	出陳
しゅってい	出廷
しゅってん	出典
しゅっとう	出頭
しゅつどう	出動
しゅつにゅう	出入
しゅつば	出馬
しゅっぱつ	出発
しゅっぱん	出帆
しゅっぱん	出版
しゅっぴ	出費
しゅっぴん	出品
しゅっぺい	出兵
じゅっぺい	恤兵
しゅつぼつ	出没
しゅっぽん	出奔
しゅつりょう	出漁
しゅつりょく	出力
しゅと	首都
しゅとう	種痘
しゅどう	主動
じゅどう	受動
しゅとく	取得
じゅなん	受難
じゅにゅう	授乳
しゅにん	主任
しゅのう	首脳
じゅのう	受納
しゅはん	主犯
しゅはん	首班
じゅばん	襦袢
しゅび	守備
しゅび	首尾
じゅひ	樹皮
しゅひつ	主筆
しゅびょう	種苗
じゅひょう	樹氷
しゅひん	主賓
しゅふ	主婦
しゅふ	首府
しゅべつ	種別
しゅほう	手法
しゅぼう	首謀
しゅみ	趣味
じゅみょう	寿命
しゅめい	主命
しゅもく	種目
じゅもく	樹木
じゅもん	呪文
しゅやく	主役
じゅよ	授与
しゅよう	主要
しゅよう	腫瘍
じゅよう	受容
じゅよう	需要
しゅら	修羅
じゅり	受理
じゅりつ	樹立
しゅりゅう	主流
しゅりょう	狩猟
しゅりょう	首領
じゅりょう	受領
しゅりょく	主力
しゅるい	種類
じゅれい	樹齢
しゅわん	手腕
じゅんい	准尉
じゅんい	順位
じゅんいつ	純一
じゅんえき	純益
じゅんえん	順延
じゅんおう	順応
じゅんか	純化
じゅんかい	巡回
しゅんかん	瞬間
じゅんかん	循環
じゅんかん	旬刊
しゅんき	春季
じゅんぎゃく	順逆
じゅんきゅう	準急
じゅんきょ	準拠
じゅんきょう	順境
じゅんぎょう	巡業
じゅんきん	純金
じゅんぎん	純銀
じゅんけつ	純潔
じゅんけつ	純血
しゅんげん	峻厳
しゅんこう	竣工
じゅんこう	巡航
じゅんこく	殉国
じゅんさ	巡査
しゅんさい	俊才
じゅんさつ	巡察
しゅんじ	瞬時
じゅんし	殉死
じゅんし	巡視
じゅんじ	順次
じゅんじつ	旬日
じゅんしゅ	遵守
しゅんじゅう	春秋
しゅんじゅん	逡巡
じゅんじゅん	順々
じゅんじゅん	諄々
じゅんじょ	順序
しゅんしょう	春宵
じゅんしょう	准将
じゅんじょう	純情
しゅんしょく	春色
じゅんしょく	殉職
じゅんしょく	潤色
じゅんしん	純真
じゅんすい	純粋
じゅんせい	純正
しゅんせつ	浚渫
じゅんぜん	純然
しゅんそく	俊足
じゅんたく	潤沢
しゅんだん	春暖
じゅんちょう	順調
じゅんど	純度
しゅんどう	蠢動
じゅんとう	順当
じゅんなん	殉難
じゅんのう	順応
しゅんば	駿馬
じゅんぱい	巡拝
じゅんぱく	純白
じゅんばん	順番
じゅんび	準備
しゅんぷう	春風
じゅんぷう	醇風
じゅんぷう	順風
しゅんぶん	春分
じゅんぶん	純分
じゅんぽう	遵法
じゅんぼく	純朴
しゅんみん	春眠
しゅんめ	駿馬
じゅんめん	純綿
じゅんもう	純毛
じゅんよう	準用
じゅんよう	巡洋
じゅんら	巡邏
じゅんり	純理
じゅんりょう	純良
じゅんれい	巡礼
しゅんれつ	峻烈
じゅんろ	順路
じょい	叙位
じょい	女医
しょいん	所員
しょいん	署員
しょいん	書院
しよう	仕様
しよう	使用
しよう	子葉
しよう	枝葉
しよう	私用
しよう	試用
しよう	飼養
じよう	滋養
じょうあい	情愛
しょうあく	掌握
しょうい	傷痍
しょうい	小異
しょうい	少尉
じょうい	上位
じょうい	情意
じょうい	譲位
じょうい	攘夷
しょういん	勝因
しょういん	承引
じょういん	上院
じょういん	乗員
じょういん	冗員
じょういん	剰員
しょうう	小雨
じょうえい	上映
しょうえん	荘園
じょうえん	上演
しょうおう	照応
じょうおん	常温
しょうか	商家
しょうか	商科
しょうか	唱歌
しょうか	昇華
しょうか	消化
しょうか	消火
しょうか	上下
しょうが	小我
じょうか	城下
じょうか	浄化
しょうかい	哨戒
しょうかい	商会
しょうかい	照会
しょうかい	紹介
しょうかい	詳解
しょうがい	碍害
しょうがい	傷害
しょうがい	渉外
しょうがい	障害
しょうがい	生害
しょうがい	生涯
じょうかい	常会
じょうがい	場外
しょうかく	昇格
しょうがく	小学
しょうがく	少額
じょうかく	城郭
しょうがつ	正月
しょうかん	償還
しょうかん	召喚
しょうかん	召還
しょうかん	将官
しょうがん	賞玩
じょうかん	上官
しょうき	勝機
しょうき	正気
しょうぎ	商議
しょうぎ	娼妓
しょうぎ	将棋
じょうき	上気
じょうき	上記
じょうき	常軌
じょうき	蒸気
じょうぎ	定木
しょうきゃく	償却
しょうきゃく	焼却
じょうきゃく	乗客
しょうきゅう	昇級
しょうきゅう	昇給
じょうきゅう	上級
しょうきょ	消去
しょうぎょう	商業
じょうきょう	上京
じょうきょう	状況
しょうきょく	消極
しょうきん	償金
しょうきん	賞金
じょうきん	常勤
しょうく	章句
じょうくう	上空
しょうぐん	将軍
じょうげ	上下
しょうけい	小計
しょうけい	捷径
しょうけい	憧憬
じょうけい	情景
しょうげき	衝撃
しょうけつ	猖獗
しょうけん	商圏
しょうけん	証券
しょうげん	証言
じょうけん	条件
じょうげん	上弦
しょうこ	称呼
しょうこ	証拠
しょうご	正午
じょうこ	上古
じょうご	上戸
しょうこう	商工
しょうこう	商港
しょうこう	将校
しょうこう	小康
しょうこう	昇降
しょうこう	消光
しょうこう	消耗
しょうこう	焼香
しょうごう	照合
しょうごう	称号
じょうこう	上皇
じょうこう	乗降
じょうこう	情交
じょうこう	条項
しょうこく	小国
しょうこく	生国
じょうこく	上告
しょうこん	商魂
しょうこん	招魂
しょうさ	少佐
じょうざ	上座
しょうさい	商才
しょうさい	詳細
じょうさい	城塞
じょうざい	浄財
じょうざい	錠剤
しょうさつ	蕭殺
しょうさん	勝算
しょうさん	硝酸
しょうさん	称賛
しょうさん	賞賛
しょうし	将士
しょうし	抄紙
しょうし	焼死
しょうし	笑止
しょうじ	商事
しょうじ	小事
しょうじ	障子
しょうじ	生死
じょうし	上梓
じょうし	上司
じょうし	城址
じょうし	情死
じょうじ	常時
じょうじ	情事
しょうじき	正直
じょうしき	常識
じょうしき	定式
しょうしつ	消失
しょうしつ	焼失
じょうじつ	情実
しょうしゃ	勝者
しょうしゃ	商社
しょうしゃ	瀟洒
じょうしゃ	乗車
じょうしゅ	城主
じょうしゅ	情趣
じょうじゅ	成就
しょうしゅう	召集
しょうしゅう	招集
しょうじゅう	小銃
じょうしゅう	常習
じょうじゅう	常住
しょうじゅつ	詳述
しょうじゅん	照準
じょうじゅん	上旬
しょうしょ	証書
しょうしょ	詔書
しょうじょ	少女
じょうしょ	情緒
じょうしょ	浄書
じょうじょ	乗除
しょうしょう	少々
しょうしょう	少将
しょうじょう	小乗
しょうじょう	症状
しょうじょう	賞状
しょうじょう	清浄
しょうじょう	猩々
しょうじょう	蕭条
じょうしょう	上昇
じょうしょう	常勝
じょうじょう	上乗
じょうじょう	情状
しょうしょく	小食
じょうしょく	常食
しょうしん	傷心
しょうしん	小心
しょうしん	昇進
しょうじん	小人
しょうじん	精進
じょうしん	上申
じょうじん	常人
じょうじん	情人
じょうず	上手
しょうすい	将帥
しょうすい	憔悴
じょうすい	上水
しょうすう	小数
しょうすう	少数
じょうすう	乗数
じょうすう	常数
しょうせい	小生
しょうせい	招請
しょうせい	笑声
じょうせい	上製
じょうせい	情勢
じょうせい	醸成
じょうせき	上席
じょうせき	定石
しょうせつ	小説
しょうせつ	章節
しょうせつ	詳説
じょうせつ	常設
じょうぜつ	饒舌
しょうせん	商船
しょうぜん	悄然
じょうせん	乗船
じょうそ	上訴
しょうそう	少壮
しょうそう	尚早
しょうそう	焦躁
しょうぞう	肖像
じょうそう	上奏
じょうそう	上層
じょうそう	情操
じょうぞう	醸造
しょうそく	消息
しょうぞく	装束
しょうそつ	将卒
しょうたい	小隊
しょうたい	招待
しょうたい	正体
じょうたい	上体
じょうたい	常態
じょうたい	状態
じょうだい	上代
しょうたく	沼沢
しょうだく	承諾
じょうたつ	上達
しょうたん	小胆
しょうだん	商談
じょうだん	上段
じょうだん	冗談
しょうち	承知
しょうち	招致
じょうち	常置
しょうちゅう	掌中
しょうちゅう	焼酎
じょうちゅう	城中
じょうちょ	情緒
しょうちょう	小腸
しょうちょう	消長
しょうちょう	象徴
じょうちょう	冗長
じょうちょう	情調
しょうちょく	詔勅
しょうちん	銷沈
じょうてい	上程
しょうてん	商店
しょうてん	昇天
しょうてん	焦点
しょうど	焦土
じょうと	譲渡
じょうど	浄土
しょうとう	消燈
しょうどう	唱導
しょうどう	衝動
しょうどう	聳動
じょうとう	上棟
じょうとう	上等
じょうとう	城頭
じょうとう	常套
じょうどう	常道
しょうとく	生得
しょうどく	消毒
しょうとつ	衝突
じょうない	城内
じょうない	場内
しょうに	小児
しょうにん	商人
しょうにん	小人
しょうにん	承認
しょうにん	証人
しょうにん	上人
じょうにん	常任
じょうにん	情人
しょうね	性根
しょうねつ	焦熱
じょうねつ	情熱
しょうねん	少年
しょうねん	生年
しょうのう	小脳
しょうのう	樟脳
じょうば	乗馬
しょうはい	勝敗
しょうはい	賞杯
しょうばい	商売
しょうばつ	賞罰
じょうはつ	蒸発
しょうばん	相伴
しょうひ	消費
しょうび	賞美
じょうひ	冗費
じょうび	常備
しょうひょう	商標
しょうびょう	傷病
しょうひん	商品
しょうひん	小品
しょうひん	賞品
じょうひん	上品
しょうふ	娼婦
しょうぶ	勝負
じょうふ	丈夫
じょうふ	情夫
じょうふ	情婦
じょうぶ	上部
じょうぶ	丈夫
しょうふう	松風
しょうふく	承服
しょうふだ	正札
じょうぶつ	成仏
しょうぶん	性分
じょうぶん	条文
しょうへい	将兵
しょうへい	招聘
しょうへき	障壁
じょうへき	城壁
しょうべん	小便
じょうほ	譲歩
しょうほう	商法
しょうほう	詳報
しょうぼう	消防
じょうほう	上方
じょうほう	乗法
じょうほう	情報
じょうほう	定法
しょうほん	抄本
じょうまえ	錠前
じょうまん	冗漫
しょうみ	賞味
しょうみ	正味
じょうみ	情味
じょうみゃく	静脈
じょうむ	常務
しょうめい	照明
しょうめい	証明
しょうめつ	消滅
しょうめん	正面
しょうもう	消耗
じょうもの	上物
しょうもん	証文
じょうもん	定紋
じょうもん	繩文
しょうや	庄屋
じょうやく	条約
しょうゆ	醤油
しょうよ	賞与
じょうよ	剰余
じょうよ	譲与
しょうよう	従容
しょうよう	商用
しょうよう	称揚
しょうよう	慫慂
しょうよう	逍遥
じょうよう	乗用
じょうよう	常用
じょうよく	情欲
しょうらい	将来
しょうらい	招来
しょうらん	照覧
しょうり	勝利
じょうり	情理
じょうり	条理
じょうりく	上陸
しょうりゃく	商略
しょうりゃく	省略
じょうりゅう	上流
じょうりゅう	蒸溜
しょうりょ	焦慮
しょうりょう	少量
しょうりょう	精霊
じょうりょく	常緑
しょうれい	奨励
しょうれい	省令
じょうれい	条令
じょうれい	条例
じょうれん	常連
しょうろく	抄録
しょうわ	唱和
しょうわ	小話
しょうわ	昭和
しょうわ	笑話
しょうわる	性悪
しょえん	初演
じょえん	助演
じょおう	女王
しょか	初夏
しょか	書家
しょか	書架
しょかい	所懐
じょがい	除外
しょかつ	所轄
しょかん	所感
しょかん	所管
しょかん	書簡
じょかん	女官
しょき	初期
しょき	所期
しょき	暑気
しょき	書紀
しょき	書記
しょきゅう	初級
じょきゅう	女給
じょきょ	除去
しょぎょう	諸行
じょきょく	序曲
しよく	私欲
しょくいき	職域
しょくいん	職員
しょぐう	処遇
しょくえん	食塩
しょくぎょう	職業
しょくご	食後
しょくざい	贖罪
しょくさん	殖産
しょくし	食指
しょくじ	植字
しょくじ	食餌
しょくじ	食事
しょくしゅ	触手
しょくじゅ	植樹
しょくじょ	織女
しょくしょう	職掌
しょくしょう	食傷
しょくせい	職制
しょくせき	職責
しょくぜん	食前
しょくぜん	食膳
しょくたく	嘱託
しょくたく	食卓
しょくつう	食通
しょくどう	食堂
しょくどう	食道
しょくにん	職人
しょくのう	職能
しょくば	職場
しょくばい	触媒
しょくはつ	触発
しょくひ	食費
しょくひん	食品
しょくぶつ	植物
しょくぶん	職分
しょくみん	植民
しょくむ	職務
しょくもく	属目
しょくもつ	食物
しょくよう	食用
しょくよく	食欲
しょくりょう	食料
しょくりょう	食糧
しょくりん	植林
しょくれき	職歴
しょくん	諸君
じょくん	叙勲
しょけい	処刑
しょけい	諸兄
しょげい	書芸
じょけい	叙景
じょけつ	女傑
しょけん	所見
しょけん	諸賢
しょげん	緒言
じょけん	女権
じょげん	助言
しょこ	書庫
しょこう	初更
しょこう	曙光
しょこう	諸侯
じょこう	女工
じょこう	徐行
しょこく	諸国
しょこん	初婚
しょさ	所作
しょさい	書斎
しょざい	所在
しょさん	所産
しょし	初志
しょし	庶子
しょし	書誌
しょじ	所持
しょじ	諸事
じょし	助詞
じょし	女史
じょし	女子
じょじ	助辞
じょじ	叙事
じょじ	女児
しょしき	書式
しょしき	諸式
しょしゃ	書写
しょじゃく	書籍
じょしゅ	助手
しょしゅう	初秋
じょしゅう	女囚
じょじゅつ	叙述
しょしゅん	初春
しょじゅん	初旬
しょじょ	処女
じょじょ	徐々
しょしょう	書証
しょじょう	書状
じょしょう	女将
じょじょう	叙情
じょじょう	抒情
じょしょく	女色
しょしん	初心
しょしん	所信
じょしん	女神
じょすう	序数
じょすう	除数
しょせい	処世
しょせい	書生
じょせい	助勢
じょせい	助成
じょせい	女性
じょせい	女婿
しょせき	書籍
じょせき	除籍
しょせつ	所説
しょせつ	諸説
じょせつ	叙説
じょせつ	序説
じょせつ	除雪
しょせん	所詮
しょせん	緒戦
しょぞう	所蔵
じょそう	女装
じょそう	除草
しょぞく	所属
しょぞん	所存
しょたい	所帯
しょたい	書体
しょだい	初代
じょたい	除隊
しょだな	書棚
しょだん	初段
しょち	処置
しょちゅう	暑中
じょちゅう	女中
しょちょう	所長
しょちょう	署長
じょちょう	助長
しょっかい	職階
しょっかく	触覚
しょっかく	触角
しょっき	織機
しょっき	食器
しょっけん	職権
しょっけん	食券
しょっこう	燭光
しょっこう	職工
しょてい	所定
しょてん	書店
しょてん	諸点
しょとう	初冬
しょとう	初等
しょとう	初頭
しょとう	諸島
しょどう	書道
しょとく	所得
しょない	所内
しょにち	初日
じょにん	叙任
しょねつ	暑熱
しょはつ	初発
しょばつ	処罰
しょはん	初版
しょはん	諸般
じょばん	序盤
しょひょう	書評
しょぶん	処分
じょぶん	序文
しょほ	初歩
しょほう	処方
しょぼう	書房
じょほう	除法
じょまく	序幕
じょまく	除幕
しょみん	庶民
しょむ	庶務
しょめい	署名
しょめい	書名
じょめい	助命
じょめい	除名
しょめん	書面
しょもう	所望
しょもく	書目
しょもつ	書物
しょや	初夜
じょや	除夜
じょやく	助役
しょゆう	所有
じょゆう	女優
しょよう	所用
しょよう	所要
しょり	処理
じょりゅう	女流
じょりょく	助力
しょるい	書類
じょれつ	序列
しょろう	初老
じょろん	序論
じらい	爾来
しらが	白髪
しらかべ	白壁
しらかみ	白紙
しらき	白木
しらぎぬ	白絹
しらくも	白雲
しらじ	白地
しらちゃ	白茶
しらつゆ	白露
しらなみ	白波
しらは	白刃
しらはた	白旗
しらべ	調べ
しらほ	白帆
しらむ	白む
しらゆき	白雪
しり	私利
じりき	自力
しりぞく	退く
しりつ	市立
しりつ	私立
じりつ	自律
じりつ	自立
しりとり	尻取
しりびと	知人
しりめ	尻目
しりゅう	支流
じりゅう	時流
しりゅうど	知人
しりょ	思慮
しりょう	史料
しりょう	死霊
しりょう	資料
しりょう	飼料
しりょく	死力
しりょく	視力
しりょく	資力
じりょく	磁力
しる	知る
しるこ	汁粉
しれい	司令
しれい	指令
じれい	事例
じれい	辞令
しれつ	歯列
しれん	試練
しろあと	城跡
しろい	白い
じろう	自労
しろうと	素人
しろくろ	白黒
しろざけ	白酒
しろじ	白地
しろみ	白身
しろめ	白目
しろもの	代物
しろん	史論
しろん	詩論
しろん	試論
じろん	持論
しわ	しわ
しわざ	仕業
しんあい	親愛
じんあい	仁愛
じんあい	塵埃
しんあん	新案
しんい	真意
しんい	神意
じんい	人為
しんいき	神域
しんいん	真因
じんいん	人員
しんえい	新鋭
じんえい	人影
じんえい	陣営
しんえん	深遠
じんえん	人煙
しんおう	震央
しんか	深化
しんか	真価
しんか	臣下
しんか	進化
じんか	人家
しんかい	深海
しんがい	侵害
しんがい	心外
しんがい	震駭
しんがお	新顔
しんがく	進学
じんかく	人格
じんがさ	陣笠
しんがた	新型
しんかん	新刊
しんかん	新館
しんかん	森閑
しんかん	神官
しんかん	震憾
しんかん	震撼
しんがん	心眼
しんがん	心願
しんき	心悸
しんき	新規
しんぎ	信義
しんぎ	審議
しんぎ	真偽
しんぎ	清規
じんぎ	仁義
しんきゅう	新旧
しんきゅう	進級
しんきゅう	鍼灸
しんきょう	信教
しんきょう	心境
しんきょう	進境
しんきん	親近
しんぎん	呻吟
しんく	真紅
しんく	辛苦
しんぐ	寝具
しんくう	真空
じんぐう	神宮
しんぐん	進軍
しんけい	神経
しんげき	新劇
しんげき	進撃
しんけつ	心血
しんげつ	新月
しんけん	真剣
しんけん	親権
しんげん	森厳
しんげん	深厳
しんげん	進言
じんけん	人権
じんけん	人絹
しんご	新語
じんご	人後
じんご	人語
しんこう	信仰
しんこう	振興
しんこう	新興
しんこう	親交
しんこう	進行
しんごう	信号
じんこう	人口
じんこう	人工
しんこく	深刻
しんこく	申告
しんこん	心魂
しんこん	新婚
しんさ	審査
しんさい	震災
じんざい	人材
しんさく	新作
しんさつ	診察
しんさん	辛酸
しんざん	新参
しんざん	深山
しんし	真摯
しんし	紳士
しんし	親子
しんじ	心事
じんじ	人事
じんじ	仁慈
しんしき	新式
しんしき	神式
しんしつ	寝室
しんじつ	真実
しんしゃ	深謝
しんじゃ	信者
じんじゃ	神社
しんしゃく	斟酌
しんしゅ	進取
しんじゅ	真珠
じんしゅ	人種
しんしゅう	真宗
しんじゅう	心中
しんしゅく	伸縮
しんしゅつ	進出
しんしゅつ	滲出
しんしゅん	新春
しんじゅん	浸潤
しんしょ	信書
しんしょ	親書
しんしょう	心証
しんしょう	神将
しんしょう	辛勝
しんじょう	信条
しんじょう	心情
しんじょう	真情
しんじょう	身上
しんじょう	進上
じんじょう	尋常
しんしょく	侵食
しんしょく	寝食
しんしん	心神
しんしん	心身
しんしん	新進
しんしん	深々
しんしん	津々
しんじん	信心
しんじん	新人
しんじん	深甚
じんしん	人心
じんしん	人身
しんすい	心酔
しんすい	浸水
しんすい	進水
しんずい	神髄
じんすい	尽瘁
しんせい	心性
しんせい	新制
しんせい	新星
しんせい	新生
しんせい	申請
しんせい	真性
しんせい	真正
しんせい	神聖
じんせい	人生
じんせい	仁政
しんせき	親戚
じんせき	人跡
しんせつ	新設
しんせつ	新説
しんせつ	深切
しんせつ	親切
しんせん	新鮮
しんせん	深浅
しんぜん	神前
しんぜん	親善
じんせん	人選
しんそう	新装
しんそう	真相
しんぞう	心臓
しんぞう	新造
じんぞう	人造
じんぞう	腎臓
しんぞく	親族
じんそく	迅速
しんそこ	心底
しんそつ	新卒
しんそつ	真率
しんたい	神体
しんたい	身体
しんたい	進退
しんだい	寝台
しんだい	身代
じんたい	人体
じんだい	神代
じんだい	甚大
しんたく	信託
しんたく	神託
しんたん	薪炭
しんだん	診断
じんち	人知
じんち	陣地
しんちく	新築
じんちく	人畜
しんちゅう	心中
しんちゅう	真鍮
しんちゅう	進駐
じんちゅう	陣中
しんちょう	伸張
しんちょう	慎重
しんちょう	新調
しんちょう	深長
しんちょう	身長
しんちょく	進捗
しんつう	心痛
じんつう	陣痛
しんてい	心底
しんてい	進呈
じんてい	人定
しんてつ	伸鉄
しんてん	親展
しんてん	進展
しんと	信徒
しんど	進度
しんとう	浸透
しんとう	神道
しんとう	親等
しんとう	滲透
しんどう	伸銅
しんどう	振動
しんどう	神童
しんどう	震動
じんとう	陣頭
じんどう	人道
じんとく	人徳
じんとく	仁徳
しんにち	親日
しんにゅう	侵入
しんにゅう	新入
しんにゅう	進入
しんにょ	真如
しんにん	信任
しんにん	信認
しんにん	新任
しんにん	親任
しんねん	信念
しんねん	新年
しんのう	親王
しんぱ	新派
じんば	人馬
しんぱい	心配
しんぱん	侵犯
しんぱん	審判
しんぱん	親藩
しんぴ	神秘
しんぴつ	親筆
しんぴょう	信憑
しんぴん	新品
じんぴん	人品
しんぷ	新婦
しんぷ	神父
しんぷく	信服
しんぷく	心服
しんぶつ	神仏
じんぶつ	人物
しんぶん	新聞
じんぶん	人文
じんぷん	人糞
しんぺん	身辺
しんぽ	進歩
しんぼう	信望
しんぼう	心棒
しんぼう	深謀
しんぼう	辛抱
じんぼう	人望
しんぼく	親睦
しんまい	新米
しんみ	新味
しんみ	親身
しんみつ	親密
しんみょう	神妙
しんみょう	身命
しんみん	臣民
じんみん	人民
しんめ	新芽
しんめい	神明
しんめい	身命
じんめい	人名
じんめい	人命
しんもつ	進物
しんもん	審問
じんもん	人文
じんもん	尋問
しんや	深夜
しんやく	新薬
しんゆう	親友
しんゆう	辛酉
しんよう	信用
じんよう	陣容
しんらい	信頼
しんらい	新来
しんらつ	辛辣
しんり	審理
しんり	心理
しんり	真理
じんりき	人力
しんりゃく	侵略
しんりょ	深慮
しんりょう	診療
しんりょく	新緑
しんりょく	深緑
じんりょく	人力
じんりょく	尽力
しんりん	森林
じんりん	人倫
しんるい	親類
じんるい	人類
しんれい	心霊
しんれき	新暦
しんろ	親露
しんろ	進路
しんろ	針路
しんろう	心労
しんろう	新郎
しんろう	辛労
しんわ	神話
しんわ	親和
すあし	素足
ずあん	図案
すい	酸い
すいあつ	水圧
すいい	推移
すいい	水位
ずいい	随意
ずいいち	随一
ずいいん	随員
すいうん	水運
すいうん	衰運
すいえい	水泳
すいえん	垂涎
すいえん	水煙
すいえん	炊煙
すいおん	水温
すいか	水火
すいがい	水害
すいがん	酔眼
すいき	水気
ずいき	随喜
すいぎゅう	水牛
すいきょ	推挙
すいきょう	水郷
すいきょう	酔狂
すいきん	水禽
すいぎん	水銀
すいくん	垂訓
すいけい	推計
すいげん	水源
すいこう	推考
すいこう	遂行
すいごう	水郷
ずいこう	随行
すいさい	水彩
すいさつ	推察
すいさん	水産
すいし	水死
すいじ	炊事
ずいじ	随時
すいしゃ	水車
すいじゃく	衰弱
すいじゅん	水準
ずいしょ	随所
すいしょう	推奨
すいしょう	推賞
すいしょう	水晶
すいじょう	水上
ずいしょう	瑞祥
すいしん	推進
すいしん	水深
すいじん	水神
すいじん	粋人
すいせい	水勢
すいせい	水星
すいせい	水棲
すいせい	彗星
すいせん	垂線
すいせん	推薦
すいせん	水洗
すいぜん	垂涎
すいそ	水素
すいそう	吹奏
すいそう	水槽
すいそう	水草
すいそう	水葬
すいぞう	膵臓
ずいそう	随想
すいそく	推測
すいだん	推断
すいちゅう	水中
すいちょう	水鳥
ずいちょう	瑞兆
すいちょく	垂直
すいてい	推定
すいてい	水底
すいてき	水滴
すいでん	水田
すいとう	出納
すいとう	水稲
すいとう	水筒
すいどう	水道
すいどう	隧道
すいなん	水難
すいばく	水爆
すいはん	垂範
すいばん	推輓
ずいはん	随伴
すいび	衰微
ずいひつ	随筆
すいふ	水夫
すいぶん	水分
ずいぶん	随分
すいへい	水兵
すいへい	水平
すいへん	水辺
すいほう	水泡
すいぼう	水防
すいぼう	衰亡
すいぼつ	水没
すいま	睡魔
すいみゃく	水脈
すいみん	睡眠
すいめつ	衰滅
すいめん	水面
すいもん	水門
すいやく	水薬
すいよう	水曜
すいよく	水浴
すいらい	水雷
すいり	推理
すいり	水利
すいりく	水陸
すいりゅう	水流
すいりょう	推量
すいりょう	水量
すいりょく	水力
すいれん	水練
すいろ	水路
すいろん	推論
すう	吸う
すうがく	数学
すうき	数奇
すうき	数寄
すうき	枢機
すうけい	崇敬
すうこう	崇高
すうし	数詞
すうじ	数字
すうじく	枢軸
すうじゅう	数十
すうせい	趨勢
すうせん	数千
ずうたい	図体
すうち	数値
すうはい	崇拝
すうひゃく	数百
すうみつ	枢密
すうよう	枢要
すうり	数理
すうりょう	数量
すえこ	末子
すえっこ	末子
すえむすめ	末娘
ずが	図画
ずかい	図解
すがお	素顔
すがたえ	姿絵
ずかん	図鑑
すき	好き
すぎ	すぎ
すぎ	過ぎ
すぎばし	杉箸
すきま	隙間
すきみ	隙見
ずきん	頭巾
すく	すく
すく	空く
すく	好く
すく	漉く
すく	抄く
すく	透く
すく	梳く
すぐ	すぐ
すくい	掬い
すくい	救い
すくう	救う
ずくてつ	銑鉄
ずけい	図形
すげがさ	菅笠
ずこう	図工
すこし	少し
すごむ	凄む
すごろく	双六
ずさん	杜撰
すし	すし
ずし	厨子
すじがね	筋金
ずしき	図式
すじみち	筋道
すじょう	素姓
ずじょう	頭上
ずず	数珠
すすかぜ	涼風
すすみ	進み
すずみ	涼み
すすむ	進む
すずむ	涼む
すすめ	勧め
すずりばこ	硯箱
ずせつ	図説
すそせん	裾線
すその	裾野
すそはば	裾幅
ずつう	頭痛
すで	素手
すてき	素敵
すと	スト
すなお	素直
すなけむり	砂煙
すなじ	砂地
すなち	砂地
すなば	砂場
すなはま	砂浜
すなはら	砂原
すなぼこり	砂埃
すなやま	砂山
ずのう	頭脳
すばこ	巣箱
ずひょう	図表
すふ	スフ
ずふ	図譜
ずぼし	図星
すみ	済み
すみ	酸味
すみえ	墨絵
すみずみ	隅々
すみぞめ	墨染
すみだわら	炭俵
すみび	炭火
すむ	済む
すむ	住む
すむ	澄む
すめん	素面
ずめん	図面
すり	すり
する	する
する	刷る
する	剃る
する	磨る
する	摸る
する	掏る
する	擂る
ずる	ずる
するどい	鋭い
ずれ	ずれ
ずろく	図録
すわ	すわ
すんいん	寸陰
すんか	寸暇
すんし	寸志
すんじ	寸時
すんぜん	寸前
すんてつ	寸鉄
すんぴょう	寸評
すんぶん	寸分
すんぽう	寸法
せい	せい
せいあつ	制圧
せいあん	成案
せいい	勢威
せいい	誠意
せいいき	声域
せいいく	成育
せいいく	生育
せいいん	成員
せいいん	成因
せいう	晴雨
せいうん	星雲
せいうん	盛運
せいうん	青雲
せいえい	清栄
せいえい	精鋭
せいえん	凄艶
せいえん	盛宴
せいえん	声援
せいえん	製塩
せいおう	西欧
せいおん	清音
せいおん	声音
せいおん	静穏
せいか	成果
せいか	正価
せいか	正課
せいか	正貨
せいか	生家
せいか	盛夏
せいか	精華
せいか	聖歌
せいか	製菓
せいか	製靴
せいか	青果
せいかい	政界
せいかい	正解
せいかい	盛会
せいかい	精解
せいかく	性格
せいかく	正確
せいがく	声楽
せいかつ	生活
せいかん	生還
せいかん	盛観
せいかん	精悍
せいかん	静観
せいがん	正眼
せいがん	誓願
せいがん	請願
ぜいかん	税関
せいき	世紀
せいき	性器
せいき	正規
せいき	清規
せいき	生気
せいき	生起
せいき	精気
せいき	西紀
せいぎ	正義
せいぎ	盛儀
せいきゅう	性急
せいきゅう	請求
せいきょ	逝去
せいぎょ	制御
せいぎょ	生魚
せいきょう	盛況
せいぎょう	正業
せいぎょう	生業
せいきょく	政局
せいきん	精勤
ぜいきん	税金
せいく	成句
せいくん	請訓
せいけい	成形
せいけい	整形
せいけい	生計
せいけつ	清潔
せいけん	政権
せいけん	政見
せいけん	聖賢
せいげん	制限
ぜいげん	贅言
せいご	正誤
せいご	生後
せいこう	性交
せいこう	性向
せいこう	性行
せいこう	成功
せいこう	正鵠
せいこう	生硬
せいこう	精巧
せいこう	製鋼
せいこう	西郊
せいこく	正鵠
せいこん	精根
せいざ	星座
せいざ	正坐
せいざ	静座
せいさい	制裁
せいさい	正妻
せいさい	生彩
せいさい	精彩
せいさい	精細
せいざい	製材
せいさく	制作
せいさく	政策
せいさく	製作
せいさん	成算
せいさん	清算
せいさん	生産
せいさん	精算
せいさん	青酸
せいさん	悽惨
せいし	制止
せいし	正史
せいし	正視
せいし	生死
せいし	製糸
せいし	製紙
せいし	誓詞
せいし	静止
せいじ	政治
せいしき	正式
せいしつ	性質
せいじつ	誠実
せいじゃ	正邪
せいじゃ	聖者
せいじゃく	静寂
ぜいじゃく	脆弱
せいしゅ	清酒
せいしゅく	星宿
せいしゅく	静粛
せいじゅく	成熟
せいしゅん	青春
せいじゅん	清純
せいしょ	清書
せいしょ	聖書
せいしょう	斉唱
せいじょう	性情
せいじょう	政情
せいじょう	正常
せいじょう	清浄
せいしょく	生殖
せいしん	清新
せいしん	精神
せいしん	西進
せいしん	誠心
せいじん	成人
せいじん	聖人
せいず	製図
せいすい	盛衰
せいずい	精髄
せいすう	整数
せいすう	正数
せいせい	生成
せいせい	精製
ぜいせい	税制
せいせき	成績
せいぜつ	悽絶
せいせん	精選
せいぜん	整然
せいぜん	生前
せいそ	清楚
せいそう	凄愴
せいそう	成層
せいそう	政争
せいそう	星霜
せいそう	正装
せいそう	清掃
せいそう	盛装
せいぞう	製造
せいそく	正則
せいそく	生息
せいぞん	生存
せいたい	政体
せいたい	生態
せいたい	声帯
せいたい	静態
せいだい	盛大
せいだく	清濁
ぜいたく	贅沢
せいだん	政談
せいだん	星団
せいち	整地
せいち	生地
せいち	聖地
せいちゃ	製茶
せいちゅう	成虫
せいちゅう	掣肘
せいちょう	成長
せいちょう	生長
せいつう	精通
せいてい	制定
せいてき	性的
せいてき	静的
せいてつ	製鉄
せいてん	晴天
せいてん	聖典
せいと	生徒
せいど	制度
せいど	精度
せいとう	征討
せいとう	政党
せいとう	正当
せいとう	正答
せいとう	正統
せいとう	精糖
せいとう	製糖
せいとう	製陶
せいどう	制動
せいどう	正道
せいどう	青銅
せいとく	生得
せいどく	精読
せいどく	西独
せいとん	整頓
せいなん	西南
ぜいにく	贅肉
せいねん	成年
せいねん	生年
せいねん	青年
せいのう	性能
せいは	制覇
せいばい	成敗
せいはく	精白
せいはつ	整髪
せいばつ	征伐
せいはん	整版
せいはん	正犯
せいはん	製版
せいばん	生蛮
せいひ	成否
せいひ	正否
せいび	整備
せいひつ	静謐
せいひょう	製氷
せいびょう	精兵
せいひん	清貧
せいひん	製品
せいふ	政府
せいぶ	西部
せいふく	制服
せいふく	征服
せいふく	正副
せいぶつ	生物
せいぶつ	静物
ぜいぶつ	贅物
せいふん	製粉
せいぶん	成分
せいぶん	成文
せいぶん	正文
せいへい	精兵
せいへき	性癖
せいべつ	性別
せいべつ	生別
せいへん	政変
せいぼ	歳暮
せいぼ	生母
せいぼ	聖母
せいほう	製法
せいほう	西方
せいぼう	制帽
せいぼう	声望
ぜいほう	税法
せいほく	西北
せいほん	製本
せいまい	精米
せいみつ	精密
せいむ	政務
ぜいむ	税務
せいめい	姓名
せいめい	生命
せいめい	盛名
せいめい	声明
せいめん	生面
せいもん	正門
せいもん	誓文
せいやく	制約
せいやく	製薬
せいやく	誓約
せいゆ	精油
せいゆ	製油
せいゆう	清遊
せいゆう	声優
せいよう	西洋
せいよう	静養
せいよく	性欲
せいらい	生来
せいり	整理
せいり	生理
せいりつ	成立
ぜいりつ	税率
せいりゃく	省略
せいりゃく	政略
せいりゅう	清流
せいりょう	清涼
せいりょう	声量
せいりょく	勢力
せいりょく	精力
せいれい	政令
せいれい	精励
せいれい	精霊
せいれい	聖霊
せいれき	西暦
せいれつ	整列
せいれつ	清冽
せいれん	清廉
せいれん	精練
せいろう	晴朗
せいろん	正論
せかい	世界
せき	せき
せきうん	積雲
せきえい	石英
せきがく	碩学
せきさい	積載
せきざい	石材
せきさん	積算
せきじ	席次
せきしゅ	隻手
せきしゅつ	析出
せきしょ	関所
せきじょう	席上
せきしょく	赤色
せきしん	赤心
せきずい	脊髄
せきせい	赤誠
せきせつ	積雪
せきそう	積層
せきぞう	石像
せきぞう	石造
せきたん	石炭
せきつい	脊椎
せきとう	石塔
せきどう	赤道
せきにん	責任
せきねん	積年
せきはい	惜敗
せきばく	寂莫
せきはん	赤飯
せきばん	石版
せきひ	石碑
せきひん	赤貧
せきぶつ	石仏
せきぶん	積分
せきへい	積弊
せきむ	責務
せきめん	赤面
せきゆ	石油
せきり	赤痢
せきりょう	寂寥
せきわけ	関脇
せく	せく
せけん	世間
せこ	世故
せこう	施行
せじ	世事
せしゅう	世襲
せじょう	世上
せじょう	世情
せじん	世人
せすじ	背筋
ぜせい	是正
せそう	世相
せぞく	世俗
せたい	世帯
せたい	世態
せたい	世代
せだい	世代
せち	世知
せつえい	設営
ぜつえん	絶縁
せっか	赤化
ぜっか	絶佳
ぜっか	舌禍
せっかい	石灰
せっかい	切開
せつがい	殺害
ぜっかい	絶海
せっかく	折角
せっかん	折檻
せっき	石器
せっき	赤旗
せっき	節季
せっきょう	説教
ぜっきょう	絶叫
せっきょく	積極
せっきん	接近
せっく	節句
ぜっく	絶句
せっけい	設計
せっけい	雪渓
ぜっけい	絶景
せっけん	席捲
せっけん	石鹸
せっけん	接見
せつげん	節減
せっこう	斥候
せっこう	石膏
せつごう	接合
ぜっこう	絶交
ぜっこう	絶好
せっさく	拙作
ぜっさん	絶賛
せつじ	接辞
せつじつ	切実
せっしゃ	拙者
せっしゃ	接写
せっしゃ	摂社
せっしゅ	接種
せっしゅ	摂取
せつじゅ	接受
せっしゅう	接収
せっしょう	殺生
せっしょう	摂政
せっしょう	折衝
ぜつしょう	絶唱
せっしょく	接触
せつじょく	雪辱
ぜっしょく	絶食
せっせい	節制
ぜっせい	絶世
せっせん	切線
せっせん	接戦
ぜっせん	舌尖
ぜっせん	舌戦
せっそう	拙僧
せっそう	節操
せっそく	拙速
せつぞく	接続
ぜっそく	絶息
せったい	接待
ぜったい	絶体
ぜったい	絶対
ぜつだい	絶大
ぜつだい	舌代
せつだん	切断
せっち	設置
せっちゅう	折衷
ぜっちょう	絶頂
せっちん	雪隠
せってい	設定
せつど	節度
せっとう	窃盗
ぜっとう	舌頭
せっとく	説得
せつな	刹那
せっぱく	切迫
せっぱく	雪白
せっぱん	折半
ぜっぱん	絶版
せつび	設備
ぜっぴつ	絶筆
ぜっぴん	絶品
せっぷく	切腹
せっぷく	説服
せっぷん	接吻
せつぶん	節分
ぜっぺき	絶壁
せっぽう	説法
せつぼう	切望
ぜっぽう	舌鋒
ぜつぼう	絶望
ぜつみょう	絶妙
ぜつむ	絶無
せつめい	説明
ぜつめい	絶命
ぜつめつ	絶滅
せつもん	設問
せつやく	節約
せつゆ	説諭
せつり	摂理
せつりつ	設立
ぜつりん	絶倫
せつれつ	拙劣
せつわ	説話
せと	瀬戸
せど	背戸
せなか	背中
ぜにん	是認
せひ	施肥
ぜひ	ぜひ
ぜひ	是非
せひょう	世評
せびろ	背広
せぼね	背骨
せまい	狭い
せまる	迫る
せみ	せみ
せめ	攻め
せめ	責め
せり	せり
せりょう	施療
せる	せる
せる	セル
ぜろ	ゼロ
せろん	世論
せわ	世話
ぜんあく	善悪
せんい	戦意
せんい	繊維
せんい	船医
ぜんい	善意
せんいつ	専一
せんいん	船員
ぜんいん	全員
せんえい	尖鋭
ぜんえい	前衛
せんえき	戦役
せんえつ	潜越
せんえつ	僣越
せんえん	遷延
せんおう	専横
せんか	専科
せんか	戦果
せんか	戦火
せんか	戦禍
せんか	選科
せんが	線画
ぜんか	前科
ぜんか	全科
せんかい	旋回
せんがい	線外
せんがい	選外
ぜんかい	前回
ぜんかい	全会
ぜんかい	全壊
ぜんかい	全快
せんかく	先覚
せんがく	浅学
ぜんがく	全額
せんかん	戦艦
せんがん	洗顔
ぜんかん	善感
せんき	戦機
せんき	戦記
せんぎ	詮議
ぜんき	前期
ぜんき	前記
せんきゃく	先客
せんきゃく	船客
ぜんきゅう	全級
せんきょ	占拠
せんきょ	選挙
せんぎょ	鮮魚
せんきょう	仙境
せんきょう	戦況
せんきょく	戦局
せんきん	千金
ぜんきん	前金
せんく	先駈
ぜんく	前駆
ぜんけい	前景
ぜんけい	全景
せんけつ	先決
せんけつ	鮮血
せんげつ	先月
ぜんげつ	前月
せんけん	先見
せんけん	浅見
せんげん	宣言
ぜんけん	全権
ぜんげん	前言
ぜんげん	漸減
せんこ	千古
せんご	戦後
ぜんご	前後
せんこう	先攻
せんこう	先考
せんこう	先行
せんこう	専攻
せんこう	戦功
せんこう	潜航
せんこう	潜行
せんこう	穿孔
せんこう	線香
せんこう	詮衡
せんこう	閃光
ぜんこう	前項
ぜんこう	善行
ぜんこう	全校
ぜんごう	前号
せんこく	先刻
せんこく	宣告
せんごく	戦国
ぜんこく	全国
ぜんこん	善根
ぜんざ	前座
せんさい	先妻
せんさい	戦災
せんさい	繊細
せんざい	洗剤
せんざい	潜在
せんさく	穿鑿
せんさく	詮索
せんし	先師
せんし	戦史
せんし	戦士
せんし	戦死
せんじ	戦時
ぜんし	全市
ぜんし	全紙
ぜんじ	漸次
ぜんじ	全治
ぜんじ	禅師
せんしつ	船室
せんじつ	先日
ぜんじつ	前日
せんしゃ	戦車
せんじゃ	選者
ぜんしゃ	前者
ぜんしゃ	前車
ぜんしゃく	前借
せんしゅ	先取
せんしゅ	船主
せんしゅ	船首
せんしゅ	選手
せんしゅう	先週
せんしゅう	選集
せんじゅう	専従
ぜんしゅう	全集
ぜんしゅう	禅宗
せんしゅつ	選出
せんじゅつ	戦術
ぜんじゅつ	前述
ぜんしょ	善処
せんしょう	戦傷
せんしょう	戦勝
せんしょう	選奨
せんしょう	僣称
せんじょう	戦場
せんじょう	洗滌
ぜんしょう	全勝
ぜんしょう	全焼
せんしょく	染色
せんしん	先進
せんしん	専心
せんじん	先人
せんじん	先陣
せんじん	戦陣
せんじん	鮮人
ぜんしん	前身
ぜんしん	前進
ぜんしん	漸進
ぜんしん	全身
せんす	扇子
せんすい	泉水
せんすい	潜水
ぜんせ	前世
せんせい	先生
せんせい	宣誓
せんせい	専制
ぜんせい	前世
ぜんせい	善政
ぜんせい	全盛
せんせき	戦跡
せんせん	宣戦
せんせん	戦線
せんぜん	戦前
ぜんせん	前線
ぜんせん	善戦
ぜんせん	全線
ぜんぜん	全然
せんぞ	先祖
せんそう	戦争
ぜんそう	前奏
ぜんぞう	漸増
せんぞく	専属
ぜんそく	喘息
ぜんそん	全村
せんたい	船体
せんたい	船隊
せんだい	先代
ぜんたい	全体
ぜんだい	前代
せんたく	洗濯
せんたく	選択
せんだつ	先達
ぜんだま	善玉
せんたん	先端
せんたん	戦端
せんだん	専断
せんだん	船団
せんち	戦地
ぜんち	全治
ぜんち	全知
せんちゃ	煎茶
せんちゃく	先着
せんちゅう	戦中
せんちょう	船長
ぜんちょう	前兆
せんて	先手
せんてい	船底
せんてい	選定
せんてい	剪定
ぜんてい	前提
せんでき	洗滌
せんてつ	先哲
せんてつ	銑鉄
せんでん	宣伝
せんと	遷都
せんど	先途
せんど	鮮度
ぜんと	前途
ぜんど	全土
せんとう	先頭
せんとう	戦闘
せんとう	銭湯
せんどう	先導
せんどう	煽動
せんどう	船頭
ぜんどう	善導
せんにゅう	先入
せんにゅう	潜入
せんにん	仙人
せんにん	先任
せんにん	専任
せんにん	選任
ぜんにん	前任
ぜんにん	善人
せんねん	先年
せんねん	専念
ぜんねん	前年
ぜんのう	前納
ぜんのう	全納
ぜんのう	全能
せんばい	専売
せんぱい	先輩
せんぱい	戦敗
ぜんぱい	全廃
ぜんぱい	全敗
せんぱく	浅薄
せんぱく	船舶
せんばつ	選抜
せんぱつ	先発
せんばん	千万
せんばん	旋盤
せんぱん	先般
せんぱん	戦犯
ぜんはん	前半
ぜんぱん	全般
せんひ	先妣
せんび	戦備
せんび	船尾
せんぴ	戦費
ぜんび	善美
ぜんぴ	前非
せんぴょう	選評
せんびん	船便
せんぶ	宣撫
せんぷ	先夫
ぜんぶ	前部
ぜんぶ	全部
せんぷう	旋風
せんぷく	潜伏
せんぷく	船腹
ぜんぷく	全幅
せんぶん	線分
ぜんぶん	前文
ぜんぶん	全文
せんべい	煎餅
ぜんべい	全米
せんべつ	餞別
せんべん	先鞭
ぜんぺん	前篇
ぜんぺん	全篇
せんぼう	羨望
せんぽう	先方
せんぽう	先鋒
せんぽう	戦法
せんぽう	旋法
ぜんぽう	前方
せんぼつ	戦没
せんまん	千万
ぜんみ	禅味
せんむ	専務
ぜんめ	全目
せんめい	鮮明
せんめつ	殲滅
ぜんめつ	全滅
せんめん	洗面
ぜんめん	前面
ぜんめん	全面
ぜんもく	全目
せんもん	専門
せんや	先夜
ぜんや	前夜
せんやく	先約
ぜんやく	全訳
せんゆう	占有
せんゆう	専有
せんゆう	戦友
せんよう	宣揚
せんよう	専用
ぜんよう	善用
ぜんら	全裸
せんらん	戦乱
せんりつ	戦慄
せんりつ	旋律
せんりゃく	戦略
ぜんりゃく	前略
せんりゅう	川柳
せんりょ	浅慮
せんりょう	占領
せんりょう	染料
ぜんりょう	善良
せんりょく	戦力
ぜんりょく	全力
せんれい	先例
せんれい	洗礼
ぜんれい	前例
ぜんれき	前歴
ぜんれつ	前列
せんれん	洗練
せんろ	線路
そあく	粗悪
ぞい	沿い
そいね	添寝
そいん	素因
そいん	訴因
そう	そう
そう	沿う
そう	左右
そう	添う
そう	副う
ぞう	ぞう
そうあい	相愛
そうあん	創案
そうあん	草案
そうい	創意
そうい	相違
そうい	総意
そういん	総員
ぞういん	増員
そううん	層雲
ぞうえい	造営
ぞうえき	増益
ぞうえん	増援
ぞうえん	造園
ぞうお	憎悪
そうおう	相応
そうおん	騒音
そうおん	噪音
ぞうか	増加
ぞうか	造化
ぞうか	造花
そうかい	壮快
そうかい	爽快
そうかい	掃海
そうかい	総会
そうがい	霜害
そうがく	奏楽
そうがく	総額
ぞうがく	増額
そうかつ	総括
そうかん	創刊
そうかん	壮観
そうかん	相関
そうかん	総監
そうかん	送還
ぞうかん	増刊
ぞうがん	象嵌
そうき	想起
そうき	早期
そうぎ	争議
そうぎ	葬儀
ぞうき	臓器
そうきゅう	早急
そうきょ	壮挙
そうぎょう	創業
そうぎょう	操業
そうぎょう	早暁
ぞうきょう	増強
そうきん	送金
ぞうきん	雑巾
そうく	痩躯
そうく	走狗
そうぐう	遭遇
そうくつ	巣窟
そうけ	宗家
ぞうげ	象牙
そうけい	早計
そうけい	総計
そうげい	送迎
ぞうけい	造形
ぞうけい	造詣
ぞうけつ	増結
そうけん	創建
そうけん	創見
そうけん	壮健
そうけん	総見
そうけん	送検
そうげん	草原
ぞうげん	雑言
ぞうげん	増減
そうこ	倉庫
そうご	壮語
そうご	相互
ぞうご	造語
そうこう	壮行
そうこう	奏効
そうこう	操行
そうこう	草稿
そうこう	装甲
そうごう	相好
そうごう	総合
そうこく	相剋
そうこん	早婚
そうこん	爪痕
そうごん	荘厳
ぞうごん	雑言
そうさ	捜査
そうさ	操作
ぞうさ	造作
そうさい	相殺
そうさい	総裁
そうさい	葬祭
そうさく	創作
そうさく	捜索
ぞうさく	造作
そうざん	早産
ぞうさん	増産
そうし	創始
そうし	壮士
そうし	相思
そうし	草紙
そうじ	掃除
そうじ	相似
ぞうし	曹司
ぞうし	増資
そうしき	葬式
そうしつ	喪失
そうしゃ	壮者
そうしゃ	奏者
そうしゃ	走者
そうしゅ	双手
そうじゅう	操縦
ぞうしゅう	増収
そうじゅく	早熟
そうしゅん	早春
そうしょ	叢書
そうしょ	草書
ぞうしょ	蔵書
そうしょう	宗匠
そうしょう	総称
そうじょう	僧正
そうじょう	奏上
そうじょう	騒擾
ぞうしょう	蔵相
そうしょく	草食
そうしょく	装飾
ぞうしょく	増殖
そうしん	喪神
そうしん	送信
ぞうしん	増進
そうすい	総帥
ぞうすい	雑炊
ぞうすい	増水
そうすう	総数
そうせい	創製
そうせい	双生
そうせい	叢生
そうぜい	総勢
ぞうぜい	増税
そうせき	踪跡
そうせつ	創設
そうせつ	総説
そうぜつ	壮絶
ぞうせつ	増設
そうぜん	騒然
ぞうせん	造船
そうそう	早々
そうそう	草創
そうそう	葬送
そうそう	淙々
そうそう	錚々
そうぞう	創造
そうぞう	想像
そうぞく	相続
そうぞく	装束
そうそん	曾孫
そうたい	早退
そうたい	相対
そうたい	総体
そうだい	壮大
そうだい	総代
ぞうだい	増大
そうたつ	送達
そうだつ	争奪
そうたん	操短
そうだん	相談
そうち	装置
ぞうちく	増築
そうちょう	早朝
そうちょう	曹長
そうちょう	総長
そうちょう	荘重
ぞうちょう	増長
そうで	総出
そうてい	想定
そうてい	装訂
ぞうてい	贈呈
そうてん	装填
そうでん	相伝
そうでん	送電
そうと	壮図
そうと	壮途
そうとう	掃蕩
そうとう	争闘
そうとう	相当
そうとう	総統
そうどう	騒動
ぞうとう	贈答
そうとく	総督
そうとん	総屯
そうなん	遭難
ぞうに	雑煮
そうにゅう	挿入
そうねん	壮年
そうは	走破
そうば	相場
ぞうはい	増配
そうはく	蒼白
そうはつ	双発
ぞうはつ	増発
そうばな	総花
そうばん	早晩
そうび	装備
そうひょう	総評
ぞうひょう	雑兵
ぞうひん	臓品
そうふ	送付
ぞうふ	臓腑
ぞうへい	造兵
ぞうへい	造幣
そうへき	双璧
そうべつ	送別
ぞうほ	増補
そうほう	双方
そうぼう	相貌
ぞうほう	増俸
そうほん	草本
そうむ	総務
そうめい	聡明
そうもく	草木
ぞうもつ	臓物
ぞうよ	贈与
そうらん	総覧
そうらん	騒乱
そうり	総理
ぞうり	草履
そうりつ	創立
そうりょ	僧侶
そうりょう	爽涼
そうりょう	総領
そうりょう	送料
そうりょく	総力
ぞうりん	造林
そうれい	壮麗
そうれい	葬礼
そうれつ	壮烈
そうろ	走路
そうろう	早老
そうろうぶん	候文
そうろん	争論
そうろん	総論
そうわ	総和
そうわ	送話
ぞうわい	贈賄
そえ	添え
そえぎ	副木
そえぢ	添乳
そえん	疎遠
そかい	疎開
そかい	租界
そかい	素懐
そがい	疎外
そがい	阻害
そかく	組閣
そがわ	蘇側
そがん	訴願
そきゅう	遡及
そぐ	そぐ
ぞくあく	俗悪
そくい	即位
ぞくえん	続演
そくおう	即応
そくおん	促音
そくぎん	即吟
ぞくぐん	賊軍
ぞくけ	俗気
ぞくご	俗語
そくざ	即座
そくさい	息災
そくし	即死
そくじ	即時
ぞくじ	俗事
そくじつ	即日
そくしゃ	速写
ぞくしゅう	俗臭
ぞくしゅつ	続出
そくじょ	息女
ぞくしょう	俗称
そくしん	促進
ぞくじん	俗人
そくせい	促成
そくせい	速成
ぞくせい	属性
ぞくせい	簇生
そくせき	即席
そくせき	足跡
ぞくせつ	俗説
ぞくぞく	続々
そくたつ	速達
そくだん	速断
そくち	測地
そくてい	測定
そくど	速度
ぞくと	賊徒
そくとう	即答
そくばい	即売
そくばく	束縛
ぞくはつ	続発
ぞくぶつ	俗物
そくぶん	仄聞
ぞくへん	続篇
そくほう	速報
ぞくみょう	俗名
ぞくめい	俗名
そくめん	側面
ぞくよう	俗謡
ぞくり	俗吏
そくりょう	測量
ぞくりょう	属僚
ぞくりょう	属領
そくりょく	速力
そくろう	足労
そげき	狙撃
そこ	そこ
そご	齟齬
そこい	底意
そこう	素行
そこう	遡航
そこく	祖国
そこぢから	底力
そこつ	粗忽
そこなう	損う
そさい	蔬菜
そざい	素材
そざつ	粗雑
そし	素志
そし	阻止
そじ	素地
そしき	組織
そしつ	素質
そしな	粗品
そしゃく	租借
そしゃく	咀嚼
そじゅつ	祖述
そしょう	訴訟
そじょう	遡上
そしょく	粗食
そすい	疏水
そすう	素数
そせい	粗製
そせい	組成
そせい	蘇生
そぜい	租税
そせき	礎石
そせん	祖先
そそ	楚々
そそう	祖宗
そそう	粗相
そぞう	塑像
そそぐ	注ぐ
そだ	粗朶
そだち	育ち
そだつ	育つ
そち	そち
そち	措置
そちゃ	粗茶
そつ	そつ
そつい	訴追
そつう	疏通
そっか	足下
ぞっか	俗化
ぞっかい	俗界
ぞっかい	続開
ぞっかん	属官
そっき	速記
そっきょう	即興
そつぎょう	卒業
ぞっきょく	俗曲
そっきん	側近
そっきん	即金
ぞっけ	俗気
そっけつ	即決
そっこう	即効
そっこう	速効
ぞっこう	続行
そっこく	即刻
ぞっこく	属国
そっせん	率先
そっちゅう	卒中
そっちょく	率直
そっとう	卒倒
そでぐち	袖口
そでした	袖下
そでたけ	袖丈
そでやま	袖山
そとうみ	外海
そとがわ	外側
そどく	素読
そとそで	外袖
そとで	外出
そとまご	外孫
そとみ	外見
そなえ	供え
そなえ	備え
その	その
そば	そば
そびょう	素描
そひん	粗品
そふ	祖父
そぼ	祖母
そぼう	粗暴
そぼく	素朴
そまつ	粗末
そむく	背く
そめ	染め
そも	そも
そや	粗野
そよう	素養
そら	そら
そらいろ	空色
そらなみだ	空涙
そらに	空似
そらね	空寝
そり	反り
そりゃく	粗略
そる	剃る
そる	反る
それ	それ
それん	ソ連
そろう	疎漏
そろばん	算盤
そんえき	損益
そんかい	村会
そんがい	損害
ぞんがい	存外
そんけい	尊敬
そんげん	尊厳
そんざい	存在
そんじ	損じ
ぞんじ	存じ
そんしつ	損失
そんしょう	尊称
そんしょう	損傷
そんしょく	遜色
そんぜい	村税
そんぞく	存続
そんぞく	尊族
そんだい	尊大
そんたく	忖度
そんち	存置
ぞんち	存知
そんちょう	尊重
そんちょう	村長
そんどう	村道
そんとく	損得
そんのう	尊王
そんぱい	存廃
そんぴ	存否
そんぴ	村費
そんぷ	尊父
ぞんぶん	存分
そんぼう	存亡
そんみん	村民
そんめい	尊名
ぞんめい	存命
そんらく	村落
そんりつ	存立
そんりつ	村立
そんりょう	損料
たい	たい
たい	タイ
たい	他意
たいあん	対案
だいあん	代案
たいい	退位
たいい	大尉
たいい	大意
だいい	題意
たいいく	体育
だいいち	第一
たいいん	退院
たいいん	隊員
たいう	大雨
たいおう	対応
だいおう	大王
たいおん	体温
たいか	耐火
たいか	滞貨
たいか	退化
たいか	大家
たいか	大火
たいか	大過
たいが	大我
だいか	代価
たいかい	退会
たいかい	大会
たいがい	対外
たいがい	大概
たいかく	体格
たいがく	退学
だいがく	大学
たいかん	体感
たいかん	耐寒
たいかん	戴冠
たいかん	退官
たいかん	大官
たいかん	大観
たいがん	対岸
たいがん	大願
だいかん	代官
だいかん	大寒
たいき	待機
たいき	大器
たいき	大気
たいぎ	大儀
だいぎ	代議
たいきゃく	退却
たいぎゃく	大逆
たいきゅう	耐久
だいきゅう	代休
たいきょ	退去
たいきょ	大挙
たいきょう	滞京
たいきょう	退京
たいぎょう	怠業
たいぎょう	大業
たいきょく	大局
たいきん	大金
だいきん	代金
たいく	体躯
だいく	大工
たいぐう	待遇
たいくつ	退屈
たいぐん	大軍
たいけい	体刑
たいけい	体形
たいけい	体系
たいけつ	対決
たいけん	体験
たいげん	体現
たいげん	大言
たいこ	太古
たいこ	太鼓
たいご	隊伍
たいご	大悟
たいこう	対抗
たいこう	対校
たいこう	退校
たいこう	大綱
だいこう	代行
たいこく	大国
だいこく	大黒
たいさ	大佐
たいさ	大差
たいざ	対坐
たいさい	大祭
たいざい	滞在
たいざい	大罪
だいざい	題材
たいさく	対策
たいさく	大作
だいさく	代作
たいさん	退散
たいし	太子
たいし	大使
たいし	大志
たいじ	対峙
たいじ	胎児
たいじ	退治
だいし	台紙
だいし	大師
だいじ	大事
たいしつ	体質
たいしゃ	退社
たいしゃ	代赭
たいしゃ	大赦
だいじゃ	大蛇
たいしゃく	貸借
たいしゅう	体臭
たいしゅう	大衆
たいじゅう	体重
たいしゅつ	退出
たいしょ	対処
たいしょ	大所
だいしょ	代書
たいしょう	対照
たいしょう	対称
たいしょう	対象
たいしょう	隊商
たいしょう	大勝
たいしょう	大将
たいしょう	大正
たいじょう	退場
だいしょう	代償
だいしょう	大小
だいじょう	大乗
たいしょく	退職
たいしょく	大食
たいしょく	褪色
たいしん	耐震
たいじん	対陣
たいじん	退陣
だいしん	代診
だいじん	大臣
だいじん	大尽
たいすい	耐水
たいすう	対数
だいすう	代数
たいせい	体制
たいせい	態勢
たいせい	胎生
たいせい	大勢
たいせい	大成
たいせい	大聖
たいせき	体積
たいせき	堆積
たいせき	退席
たいせつ	大切
たいせん	対戦
たいせん	大戦
たいぜん	泰然
たいそう	体操
たいそう	大層
たいだ	怠惰
だいだ	代打
だいたい	代替
だいたい	大体
だいたい	大隊
だいだい	代々
たいだん	対談
だいたん	大胆
たいち	対置
だいち	台地
だいち	大地
たいちょう	退庁
たいちょう	隊長
だいちょう	台帳
だいちょう	大腸
たいてい	退廷
たいてい	大抵
たいてき	対敵
たいてき	大敵
たいてん	大典
たいど	態度
たいとう	対当
たいとう	対等
たいとう	抬頭
たいどう	帯同
たいどう	胎動
だいどう	大道
たいとく	体得
だいどく	代読
だいどころ	台所
たいない	体内
たいない	胎内
たいにち	対日
たいにち	滞日
たいにん	退任
たいにん	大任
だいにん	代人
たいねつ	耐熱
たいのう	滞納
だいのう	大脳
だいのう	大農
たいは	大破
たいはい	大敗
たいはい	頽廃
だいばかり	台秤
たいばつ	体罰
たいはん	大半
たいはん	大藩
たいばん	胎盤
たいひ	堆肥
たいひ	対比
たいひ	待避
だいひつ	代筆
たいびょう	大病
だいひょう	代表
たいふ	大夫
たいぶ	大部
だいぶ	大夫
だいぶ	大分
たいふう	台風
だいふく	大福
だいぶつ	大仏
だいぶん	大分
たいへい	太平
たいべつ	大別
たいへん	大変
だいべん	代弁
だいべん	大便
たいほ	退歩
たいほ	逮捕
たいほう	大砲
たいぼう	耐乏
たいぼう	待望
たいぼう	大望
たいぼく	大木
たいほん	大本
だいほん	台本
たいまん	怠慢
だいみょう	大名
だいめい	題名
たいめん	体面
たいめん	対面
たいもう	大望
だいもく	題目
たいや	逮夜
たいやく	大役
たいやく	大約
だいやく	代役
たいよ	貸与
たいよう	太陽
たいよう	大洋
たいよう	大要
だいよう	代用
たいらん	大乱
だいり	代理
だいり	内裏
だいりき	大力
たいりく	大陸
たいりつ	対立
たいりゃく	大略
たいりゅう	対流
たいりょう	大漁
たいりょう	大量
たいりょく	体力
たいれつ	隊列
たいろ	退路
たいわ	対話
たいわん	台湾
たいん	多淫
たうえ	田植
だうま	駄馬
だえき	唾液
だえん	楕円
たおす	倒す
たか	たか
たが	たが
だが	だが
たかい	高い
たかい	他界
たがい	互い
だかい	打開
たがう	違う
たかく	多角
たがく	多額
たかさ	高さ
たかしお	高潮
たかぞら	高空
たかだい	高台
たかだか	高々
たかどの	高殿
たかね	高値
たかね	高峰
たかひく	高低
たかまくら	高枕
たかみ	高み
たからぶね	宝船
たからもの	宝物
だかん	兌換
たき	多岐
たぎ	多義
だき	惰気
たきょう	他郷
だきょう	妥協
たく	炊く
たく	焚く
だく	抱く
たくあん	沢庵
たくえつ	卓越
だくおん	濁音
たくさん	沢山
たくじょう	卓上
たくしょく	拓植
たくせつ	卓説
たくぜつ	卓絶
たくせん	託宣
たくそう	託送
たくち	宅地
だくてん	濁点
たくはつ	托鉢
たくばつ	卓抜
だくひ	諾否
たくみ	巧み
だくりゅう	濁流
たくわえ	貯え
たくわん	沢庵
たけ	たけ
だけ	だけ
たけい	猛い
たげい	多芸
たけうま	竹馬
たけがき	竹垣
だげき	打撃
たけざお	竹竿
たけつ	多血
だけつ	妥結
たけやぶ	竹薮
たける	猛る
たげん	多言
たこ	たこ
たご	たご
たこう	他校
たこう	他行
たこう	多幸
だこう	蛇行
たこく	他国
たごん	他言
たさい	多彩
たさい	多才
たさく	多作
ださく	駄作
たさつ	他殺
たさん	多産
ださん	打算
たし	足し
たじ	他事
たじ	多事
だし	山車
だし	出し
たしか	確か
たしつ	多湿
たじつ	他日
たしゃ	多謝
だしゃ	打者
だじゃく	惰弱
だじゃく	懦弱
たしゅ	多種
だじゅん	打順
たしょう	他称
たしょう	多少
だしん	打診
たす	足す
だす	出す
たすう	多数
だすう	打数
たすけ	助け
たぜい	多勢
だせい	惰性
だせき	打席
だそく	蛇足
ただ	ただ
だだ	駄々
ただい	多大
たたかう	戦う
ただす	糾す
ただす	質す
ただす	正す
たたみおもて	畳表
たたむ	畳む
ただよう	漂う
たたん	多端
たち	たち
たち	立ち
たちば	立場
たちやく	立役
だちん	駄賃
たつ	たつ
たつ	経つ
たつ	建つ
たつ	裁つ
たつ	断つ
たつ	立つ
だつい	脱衣
だっかい	奪回
たっかん	達観
だっかん	奪還
だっきゃく	脱却
たっきゅう	卓球
だっきゅう	脱臼
たっきょ	謫居
たっけん	卓見
たっけん	達見
だっこう	脱稿
だっこく	脱穀
だつごく	脱獄
たっし	達し
だつじ	脱字
たっしゃ	達者
だっしゅ	奪取
だっしゅう	脱臭
だっしゅつ	脱出
だっしょく	脱色
たつじん	達人
だっすい	脱水
たっせい	達成
だつぜい	脱税
だっせん	脱線
だっそう	脱走
だつぞく	脱俗
だったい	脱退
たっちゅう	塔頭
たっとい	貴い
だっとう	脱党
たっとぶ	尊ぶ
たづな	手綱
だっぴ	脱皮
たっぴつ	達筆
だっぽう	脱法
だつぼう	脱帽
たつまき	竜巻
だつもう	脱毛
だつらく	脱落
だつりゃく	奪略
たて	たて
たて	建て
たて	殺陣
たて	立て
たで	たで
だて	だて
たてあな	竪穴
たてぐ	建具
たてこう	竪坑
たてじ	縦地
たてぬき	経緯
たてね	建値
たてまつる	奉る
だでん	打電
たどう	他動
だとう	妥当
だとう	打倒
たどん	炭団
たなん	多難
だに	だに
たにがわ	谷川
たにそこ	谷底
たにま	谷間
たにん	他人
たね	たね
たねあぶら	種油
たねいた	種板
たねいも	種芋
たねうし	種牛
たねうま	種馬
たねほん	種本
たねん	他年
たねん	多年
たのう	多能
たのみ	頼み
たのむ	頼む
だは	打破
だば	駄馬
たはた	田畑
たはつ	多発
たび	足袋
だび	蛇尾
たびごころ	旅心
たびさき	旅先
たびじ	旅路
たびたび	度々
たびびと	旅人
たふ	タフ
たぶん	他聞
たべん	多弁
だべん	駄弁
だほ	拿捕
たほう	他方
たぼう	多忙
だぼく	打撲
たま	たま
たまう	給う
たまぐし	玉串
たまざん	珠算
たまぶち	玉縁
だみん	惰眠
だむ	ダム
たむし	田虫
ため	ため
ため	溜め
だめ	だめ
ためん	他面
ためん	多面
たも	たも
たもつ	保つ
たゆう	大夫
たよう	多様
たよう	多用
たより	頼り
たよる	頼る
たら	たら
だらく	堕落
たりき	他力
たりつ	他律
だりつ	打率
たりょう	多量
だりょく	惰力
たる	足る
たるき	垂木
たれ	たれ
だれ	だれ
だんあつ	弾圧
だんあん	断案
たんい	単位
たんいつ	単一
だんいん	団員
たんか	単価
たんか	担架
たんか	炭化
たんか	短歌
たんかい	坦懐
だんかい	段階
だんがい	弾劾
だんがい	断崖
たんがん	単眼
たんがん	嘆願
だんがん	弾丸
たんき	短期
たんき	短気
たんきゅう	探求
たんきゅう	探究
だんきゅう	段丘
たんぐつ	短靴
だんけつ	団結
たんけん	探検
たんげん	単元
だんげん	断言
たんご	単語
たんご	端午
だんこ	断乎
だんご	団子
たんこう	炭坑
だんこう	団交
だんこう	断交
だんこう	断行
だんごう	談合
だんごく	暖国
だんこん	弾痕
たんさ	探査
たんざ	端坐
たんさい	単彩
たんさい	淡彩
だんざい	断罪
たんさく	探索
たんざく	短冊
たんさつ	探察
たんさん	炭酸
たんし	譚詩
だんし	男子
だんじ	男児
たんしき	単式
だんじき	断食
だんしゃく	男爵
たんじゅう	短銃
たんしゅく	短縮
たんじゅん	単純
たんしょ	短所
たんしょ	端緒
だんじょ	男女
たんしょう	嘆賞
たんしょう	探勝
たんしょう	短小
たんじょう	誕生
だんしょう	男娼
だんしょう	談笑
たんしょく	単色
だんしょく	暖色
たんしん	単身
たんしん	短針
たんす	箪笥
たんすい	淡水
だんすい	断水
たんすう	単数
たんせい	丹誠
たんせい	嘆声
たんせい	端正
だんせい	弾性
だんせい	男性
だんぜつ	断絶
たんせん	単線
たんぜん	丹前
たんぜん	端然
だんせん	断線
だんぜん	断然
たんそ	炭素
たんそう	炭層
だんそう	弾奏
だんそう	断層
だんそう	男装
たんそく	嘆息
だんぞく	断続
だんたい	団体
たんたん	坦々
たんたん	淡々
だんだん	段々
たんち	探知
だんち	団地
たんちょ	端緒
たんちょう	単調
たんちょう	短調
だんちょう	団長
だんちょう	断腸
たんてい	探偵
だんてい	断定
たんてき	端的
たんでき	耽溺
たんでん	炭田
たんとう	担当
たんとう	短刀
だんとう	暖冬
だんどう	弾道
たんどく	単独
たんどく	耽読
だんな	旦那
たんに	単に
たんにん	担任
たんねん	丹念
だんねん	断念
たんのう	堪能
たんのう	胆嚢
たんぱ	短波
たんばい	探梅
たんぱく	淡白
だんばた	段畑
たんぱつ	単発
だんぱつ	断髪
だんぱん	談判
たんび	嘆美
たんぷく	単複
たんぶん	単文
たんぶん	短文
たんぺん	短篇
だんぺん	断片
たんぽ	担保
たんぼう	探訪
だんぼう	暖房
たんめい	短命
だんめん	断面
たんもの	反物
だんやく	弾薬
だんらく	段落
だんらん	団欒
たんり	単離
だんりゅう	暖流
たんりょ	短慮
たんりょく	胆力
だんりょく	弾力
たんれい	端麗
たんれん	鍛練
だんろ	煖炉
だんろん	談論
だんわ	談話
ちあん	治安
ちい	地位
ちいき	地域
ちいく	知育
ちえ	智慧
ちえん	遅延
ちか	治下
ちか	地下
ちか	地価
ちかい	近い
ちかい	誓い
ちかい	地階
ちがい	違い
ちかう	誓う
ちがう	違う
ちがえ	違え
ちかく	近く
ちかく	知覚
ちかく	地殻
ちがく	地学
ちかぢか	近々
ちかみち	近道
ちかめ	近眼
ちかん	弛緩
ちかん	痴漢
ちかん	置換
ちき	知己
ちき	稚気
ちきゅう	地球
ちきょう	地峡
ちぎり	契り
ちぎる	契る
ちぎん	地銀
ちく	地区
ちくいち	逐一
ちぐう	知遇
ちくこう	築港
ちぐさ	千草
ちくざい	蓄財
ちくさつ	畜殺
ちくさん	畜産
ちくじ	逐次
ちくしょう	畜生
ちくじょう	築城
ちくじょう	逐条
ちくせき	蓄積
ちくでん	蓄電
ちくば	竹馬
ちくび	乳首
ちくりん	竹林
ちけい	地形
ちけん	地検
ちご	稚児
ちこく	治国
ちこく	遅刻
ちさい	地裁
ちさん	治山
ちさん	遅参
ちし	地誌
ちし	致死
ちじ	知事
ちしお	血潮
ちしき	知識
ちじく	地軸
ちしつ	知悉
ちしつ	地質
ちしゃ	智者
ちじょう	地上
ちじょう	痴情
ちじょく	恥辱
ちじん	知人
ちじん	痴人
ちず	地図
ちすい	治水
ちせい	治世
ちせい	知性
ちせい	地勢
ちせき	治績
ちそ	地租
ちそう	地層
ちそう	馳走
ちそく	遅速
ちたい	地帯
ちたい	遅滞
ちち	遅々
ちちうえ	父上
ちちうし	乳牛
ちちおや	父親
ちちぎみ	父君
ちちくび	乳首
ちちはは	父母
ちぢみ	縮み
ちぢむ	縮む
ちちゅう	地中
ちっこう	築港
ちつじょ	秩序
ちっそ	窒素
ちっそく	窒息
ちてい	地底
ちてき	知的
ちてん	地点
ちとく	智徳
ちどん	遅鈍
ちねつ	地熱
ちのう	知能
ちはん	池畔
ちばん	地番
ちび	ちび
ちひつ	遅筆
ちひょう	地表
ちぶさ	乳房
ちへん	地変
ちほ	地歩
ちほう	地方
ちほう	痴呆
ちぼう	知謀
ちみ	地味
ちみつ	緻密
ちめい	知名
ちめい	地名
ちめい	致命
ちゃ	ちゃ
ちゃいろ	茶色
ちゃえん	茶園
ちゃか	茶菓
ちゃがま	茶釜
ちゃき	茶器
ちゃくい	着意
ちゃくい	着衣
ちゃくえき	着駅
ちゃくがん	着眼
ちゃくざ	着座
ちゃくし	嫡子
ちゃくじつ	着実
ちゃくしゅ	着手
ちゃくしょく	着色
ちゃくしん	着信
ちゃくすい	着水
ちゃくせき	着席
ちゃくそう	着想
ちゃくちゃく	着々
ちゃくにん	着任
ちゃくふく	着服
ちゃくもく	着目
ちゃくよう	着用
ちゃくりく	着陸
ちゃくりゅう	嫡流
ちゃしつ	茶室
ちゃだい	茶代
ちゃっこう	着工
ちゃてん	茶店
ちゃどう	茶道
ちゃばなし	茶話
ちゃびん	茶瓶
ちゃみせ	茶店
ちゃめ	茶目
ちゃや	茶屋
ちゃわ	茶話
ちゆ	治癒
ちゆう	知勇
ちゆう	知友
ちゅうい	中尉
ちゅうい	注意
ちゅうえい	中衛
ちゅうおう	中央
ちゅうか	中華
ちゅうかい	仲介
ちゅうかい	注解
ちゅうがい	中外
ちゅうかく	中核
ちゅうがく	中学
ちゅうがた	中型
ちゅうかん	中間
ちゅうかん	昼間
ちゅうき	中気
ちゅうき	注記
ちゅうぎ	忠義
ちゅうきゅう	中級
ちゅうきょう	中共
ちゅうきん	忠勤
ちゅうくう	中空
ちゅうぐう	中宮
ちゅうけい	中継
ちゅうけん	中堅
ちゅうげん	中元
ちゅうげん	忠言
ちゅうこ	中古
ちゅうこう	中興
ちゅうこう	忠孝
ちゅうこく	忠告
ちゅうごく	中国
ちゅうごし	中腰
ちゅうさ	中佐
ちゅうざ	中座
ちゅうさい	仲裁
ちゅうざい	駐在
ちゅうさつ	駐剳
ちゅうさん	昼餐
ちゅうし	中止
ちゅうし	注視
ちゅうじき	中食
ちゅうじく	中軸
ちゅうじつ	忠実
ちゅうしゃ	注射
ちゅうしゃ	駐車
ちゅうしゃく	注釈
ちゅうしゅう	仲秋
ちゅうしゅつ	抽出
ちゅうじゅん	中旬
ちゅうしょう	中傷
ちゅうしょう	抽象
ちゅうじょう	中将
ちゅうじょう	衷情
ちゅうしょく	昼食
ちゅうしん	中心
ちゅうしん	忠臣
ちゅうしん	注進
ちゅうしん	衷心
ちゅうすい	注水
ちゅうすう	中数
ちゅうすう	中枢
ちゅうせい	中世
ちゅうせい	中性
ちゅうせい	中正
ちゅうせい	忠誠
ちゅうぜい	中背
ちゅうせき	柱石
ちゅうせつ	忠節
ちゅうぜつ	中絶
ちゅうせん	抽選
ちゅうぞう	鋳造
ちゅうたい	中退
ちゅうたい	中隊
ちゅうだん	中断
ちゅうだん	中段
ちゅうちょ	躊躇
ちゅうてん	中天
ちゅうてん	中点
ちゅうと	中途
ちゅうとう	中等
ちゅうどう	中道
ちゅうどく	中毒
ちゅうとん	駐屯
ちゅうにく	中肉
ちゅうにち	中日
ちゅうにち	駐日
ちゅうにゅう	注入
ちゅうにん	仲人
ちゅうねん	中年
ちゅうはん	昼飯
ちゅうばん	中盤
ちゅうび	中火
ちゅうぶ	中部
ちゅうぶう	中風
ちゅうふく	中腹
ちゅうぶる	中古
ちゅうへい	駐兵
ちゅうべい	中米
ちゅうぼく	忠僕
ちゅうぼそ	中細
ちゅうみつ	稠密
ちゅうもく	注目
ちゅうもん	注文
ちゅうや	中夜
ちゅうや	昼夜
ちゅうゆ	注油
ちゅうゆう	忠勇
ちゅうよう	中庸
ちゅうりつ	中立
ちゅうりゃく	中略
ちゅうりゅう	中流
ちゅうりゅう	駐留
ちゅうりょう	忠良
ちゅうろう	中老
ちゅうわ	中和
ちよ	千代
ちょうあい	寵愛
ちょうい	弔慰
ちょういん	調印
ちょうえき	懲役
ちょうえつ	超越
ちょうおん	調音
ちょうおん	長音
ちょうか	超過
ちょうかい	懲戒
ちょうかい	朝会
ちょうかい	町会
ちょうかく	聴覚
ちょうかく	頂角
ちょうかん	朝刊
ちょうかん	長官
ちょうき	弔旗
ちょうき	長期
ちょうきょう	調教
ちょうきん	超勤
ちょうけい	長兄
ちょうけい	長径
ちょうこう	兆候
ちょうこう	朝貢
ちょうこう	聴講
ちょうごう	調合
ちょうこく	彫刻
ちょうこく	超克
ちょうさ	調査
ちょうざ	長座
ちょうざい	調剤
ちょうし	調子
ちょうし	銚子
ちょうし	長子
ちょうじ	寵児
ちょうじ	弔辞
ちょうじゃ	長者
ちょうしゅ	聴取
ちょうじゅ	長寿
ちょうしゅう	徴収
ちょうしゅう	徴集
ちょうしゅう	聴衆
ちょうじゅう	鳥獣
ちょうしょ	調書
ちょうしょ	長所
ちょうじょ	長女
ちょうしょう	嘲笑
ちょうじょう	長上
ちょうじょう	頂上
ちょうしょく	朝食
ちょうじり	帳尻
ちょうしん	調進
ちょうしん	長身
ちょうしん	長針
ちょうじん	超人
ちょうず	手水
ちょうせい	町政
ちょうせい	調整
ちょうせい	調製
ちょうせい	長逝
ちょうぜい	徴税
ちょうぜい	町税
ちょうせき	朝夕
ちょうせき	潮汐
ちょうせつ	調節
ちょうせん	挑戦
ちょうせん	朝鮮
ちょうぜん	超然
ちょうそ	彫塑
ちょうぞう	彫像
ちょうそく	長足
ちょうそん	町村
ちょうだ	長打
ちょうだい	長大
ちょうだい	頂戴
ちょうたつ	調達
ちょうたん	長短
ちょうちゃく	打擲
ちょうちょう	町長
ちょうちょう	長調
ちょうちん	提灯
ちょうつがい	蝶番
ちょうてい	朝廷
ちょうてい	調停
ちょうてん	頂点
ちょうでん	弔電
ちょうと	長途
ちょうど	調度
ちょうな	手斧
ちょうない	町内
ちょうなん	長男
ちょうにん	重任
ちょうにん	町人
ちょうは	長波
ちょうば	帳場
ちょうはつ	徴発
ちょうはつ	挑発
ちょうばつ	懲罰
ちょうぶ	町歩
ちょうふく	重複
ちょうぶく	調伏
ちょうぶん	弔文
ちょうぶん	長文
ちょうへい	徴兵
ちょうへん	長篇
ちょうぼ	帳簿
ちょうぼ	徴募
ちょうほう	重宝
ちょうほう	諜報
ちょうぼう	眺望
ちょうみ	調味
ちょうみん	町民
ちょうめ	丁目
ちょうめい	町名
ちょうめい	長命
ちょうめん	帳面
ちょうもん	弔問
ちょうもん	聴聞
ちょうや	朝野
ちょうやく	跳躍
ちょうよう	徴用
ちょうよう	長幼
ちょうらく	凋落
ちょうり	調理
ちょうりつ	調律
ちょうりゅう	潮流
ちょうりょう	跳梁
ちょうりょく	聴力
ちょうるい	鳥類
ちょうれい	朝礼
ちょうれん	調練
ちょうろう	長老
ちょうろう	嘲弄
ちょうわ	調和
ちょきん	貯金
ちょくえい	直営
ちょくげき	直撃
ちょくげん	直言
ちょくご	勅語
ちょくご	直後
ちょくし	直視
ちょくじ	植字
ちょくしゃ	直射
ちょくしん	直進
ちょくせつ	直接
ちょくせん	直線
ちょくぜん	直前
ちょくぞく	直属
ちょくちょう	直腸
ちょくつう	直通
ちょくばい	直売
ちょくめん	直面
ちょくやく	直訳
ちょくゆ	勅諭
ちょくりつ	直立
ちょくりゅう	直流
ちょくれつ	直列
ちょげん	緒言
ちょさく	著作
ちょしゃ	著者
ちょじゅつ	著述
ちょしょ	著書
ちょすい	貯水
ちょせん	緒戦
ちょぞう	貯蔵
ちょたん	貯炭
ちょちく	貯蓄
ちょっか	直下
ちょっかく	直覚
ちょっかく	直角
ちょっかつ	直轄
ちょっかん	直感
ちょっかん	直観
ちょっきゅう	直球
ちょっけい	直径
ちょっけい	直系
ちょっけつ	直結
ちょっこう	直航
ちょっこう	直行
ちょとつ	猪突
ちょめい	著名
ちょろん	緒論
ちら	ちら
ちらん	治乱
ちり	地理
ちりめん	縮緬
ちりょう	治療
ちりょく	知力
ちる	散る
ちん	ちん
ちんあつ	鎮圧
ちんうつ	沈欝
ちんか	沈下
ちんか	鎮火
ちんき	珍奇
ちんきゃく	珍客
ちんぎん	賃金
ちんこう	沈降
ちんこん	鎮魂
ちんざ	鎮座
ちんし	沈思
ちんじ	椿事
ちんしゃ	陳謝
ちんじゅ	鎮守
ちんじゅう	珍獣
ちんじゅつ	陳述
ちんじょう	陳情
ちんせい	沈静
ちんせん	沈潜
ちんたい	沈滞
ちんたい	賃貸
ちんだん	珍談
ちんちゃく	沈着
ちんちょう	珍重
ちんちょう	珍鳥
ちんつう	沈痛
ちんてい	鎮定
ちんでん	沈澱
ちんぴん	珍品
ちんぶ	鎮撫
ちんぷ	陳腐
ちんぶん	珍聞
ちんぼつ	沈没
ちんぽん	珍本
ちんみ	珍味
ちんみょう	珍妙
ちんもく	沈黙
ちんゆう	沈勇
ちんれつ	陳列
つい	つい
ついおく	追憶
ついか	追加
ついかい	追懐
ついき	追記
ついきゅう	追及
ついきゅう	追求
ついきゅう	追究
ついく	対句
ついげき	追撃
ついし	墜死
ついし	追試
ついじゅう	追従
ついしょう	追従
ついしん	追伸
ついずい	追随
ついせき	追跡
ついぜん	追善
ついそう	追想
ついたち	一日
ついちょう	追徴
ついとう	追悼
ついとつ	追突
ついな	追儺
ついに	遂に
ついび	追尾
ついほ	追補
ついぼ	追慕
ついほう	追放
ついらく	墜落
つう	ツー
つううん	通運
つうか	通貨
つうか	通過
つうかい	痛快
つうかく	痛覚
つうがく	通学
つうかん	痛感
つうかん	通観
つうき	通気
つうぎょう	通暁
つうきん	通勤
つうこう	通行
つうこく	通告
つうこん	痛恨
つうさん	通産
つうさん	通算
つうじ	通じ
つうしょう	通商
つうしょう	通称
つうじょう	通常
つうしん	痛心
つうしん	通信
つうじん	通人
つうすい	通水
つうせき	痛惜
つうせつ	痛切
つうせつ	通説
つうぞく	通俗
つうたつ	通達
つうたん	痛嘆
つうち	通知
つうちょう	通帳
つうちょう	通牒
つうどく	通読
つうねん	通念
つうふう	通風
つうぶん	通分
つうへい	通弊
つうほう	通報
つうやく	通訳
つうよう	痛痒
つうよう	通用
つうらん	通覧
つうれい	通例
つうろ	通路
つうろん	通論
つうわ	通話
つか	つか
つかう	使う
つかまつる	仕る
つかれ	疲れ
つき	突き
つき	付き
つき	搗き
つぎ	継ぎ
つぎ	次ぎ
つぎ	続ぎ
つきずえ	月末
つきづき	月々
つきひ	月日
つきみ	月見
つきやま	築山
つきよ	月夜
つく	つく
つく	就く
つく	着く
つく	突く
つく	付く
つく	憑く
つく	搗く
つぐ	つぐ
つぐ	継ぐ
つぐ	次ぐ
つぐ	続ぐ
つくだに	佃煮
つぐない	償い
つぐなう	償う
つくり	造り
つくる	作る
つくろい	繕い
つけ	付け
つごう	都合
つじうら	辻占
つた	つた
づたい	伝い
つたえ	伝え
つちいろ	土色
つちぐるま	土車
つちけむり	土煙
つちふね	土船
つづき	続き
つづく	続く
つつさき	筒先
つつしみ	慎み
つつしむ	謹む
つつそで	筒袖
つつみ	包み
つつむ	包む
つづり	綴り
つて	つて
つと	つと
つど	都度
つどい	集い
つとに	夙に
つとめ	勤め
つとめ	務め
つなみ	津波
つねづね	常々
つねに	常に
つのだる	角樽
つのぶえ	角笛
つのる	募る
つば	つば
つぶし	潰し
つぶれ	潰れ
つぼむ	蕾む
つまこ	妻子
つみ	摘み
つみびと	罪人
つむ	つむ
つむ	積む
つむぐ	紡ぐ
つめ	詰め
づめ	詰め
つめあと	爪痕
つめしょ	詰所
つや	つや
つや	通夜
つゆ	つゆ
つよい	強い
つよき	強気
つよごし	強腰
つよさ	強さ
つよび	強火
つよみ	強み
つらい	辛い
つらだましい	面魂
つり	釣り
つりいと	釣糸
つりがね	釣鐘
つりひも	吊紐
つる	つる
つる	釣る
つるかめ	鶴亀
つるくさ	蔓草
つるはし	鶴嘴
つれ	ツレ
つれ	連れ
てあい	手合
てあか	手垢
てあし	手足
であし	出足
てあて	手当
ていあん	提案
ていい	低位
ていい	帝位
ていいん	定員
ていえん	庭園
ていおう	帝王
ていおん	低温
ていおん	低音
ていか	低下
ていか	定価
ていかい	低徊
ていかい	停会
ていがく	低額
ていがく	停学
ていがく	定額
ていかん	定款
ていき	定期
ていき	提起
ていぎ	定義
ていぎ	提議
ていきゅう	低級
ていきゅう	定休
ていきゅう	庭球
ていきょう	帝京
ていきょう	提供
ていきん	庭訓
ていきん	提琴
ていくう	低空
ていけい	定型
ていけい	提携
ていけい	梯形
ていけつ	締結
ていけん	定見
ていげん	逓減
ていこう	抵抗
ていこく	定刻
ていこく	帝国
ていさい	体裁
ていさつ	偵察
ていし	停止
ていじ	呈示
ていじ	定時
ていじ	提示
ていしき	定式
ていしゃ	停車
ていしゅ	亭主
ていじゅう	定住
ていしゅく	貞淑
ていしゅつ	提出
ていじょ	貞女
ていしょう	提唱
ていじょう	呈上
ていしょく	定植
ていしょく	定職
ていしょく	定食
ていしょく	抵触
ていしん	挺身
ていしん	艇身
ていしん	逓信
でいすい	泥水
でいすい	泥酔
ていすう	定数
ていせい	低声
ていせい	帝制
ていせい	帝政
ていせい	訂正
ていせつ	貞節
ていせつ	定説
ていせん	停戦
ていせん	停船
ていぜん	庭前
ていそ	提訴
ていそう	貞操
ていそう	逓送
ていぞく	低俗
ていたい	停滞
ていたく	邸宅
ていだん	鼎談
ていち	低地
ていち	定置
ていちゃく	定着
ていちょう	低調
ていちょう	鄭重
ていてい	亭々
ていてつ	蹄鉄
ていでん	停電
ていど	程度
でいど	泥土
ていとう	抵当
ていとく	提督
ていとん	停頓
ていねい	丁寧
でいねい	泥寧
ていねん	丁年
ていねん	停年
ていねん	定年
ていのう	低能
ていはく	停泊
ていはつ	剃髪
ていひょう	定評
ていふ	貞婦
ていへん	底辺
ていぼう	堤防
ていぼく	低木
ていほん	定本
ていほん	底本
ていまい	弟妹
ていめい	低迷
ていめい	締盟
ていめん	底面
ていよう	提要
ていらく	低落
ていり	低利
ていり	定理
ていりつ	鼎立
ていりゅう	停留
ていりょう	定量
ていれい	定例
ていれん	低廉
ていろん	定論
てうす	手薄
でえ	デー
ておけ	手桶
ておの	手斧
てかず	手数
てがた	手形
てがみ	手紙
てがら	手柄
てがる	手軽
てき	−的
でき	出来
できあい	溺愛
てきい	敵意
てきおう	適応
てきかく	的確
てきかく	適格
てきかく	適確
てきがた	敵方
てきぎ	適宜
てきぐん	敵軍
てきごう	適合
てきざい	適材
てきし	敵視
てきじ	適時
できし	溺死
てきしゃ	適者
てきしゅ	敵手
てきしゅつ	剔出
てきしょ	適所
てきしょう	敵将
てきしょう	適称
てきじん	敵陣
てきせい	敵性
てきせい	適性
てきせい	適正
てきせつ	適切
てきぜん	敵前
てきたい	敵対
てきだん	敵弾
てきち	敵地
てきちゅう	適中
てきど	適度
てきとう	適当
てきにん	適任
てきはつ	摘発
てきひ	適否
てきひょう	適評
てきへい	敵兵
てきめん	覿面
てきやく	適役
てきやく	適訳
てきよう	摘要
てきよう	適用
てきりょう	適量
てきれい	適例
てきれい	適齢
てぎわ	手際
てくせ	手癖
てぐち	手口
でぐち	出口
てくび	手首
てぐるま	手車
てこ	梃子
てさき	手先
でさき	出先
でし	弟子
てしお	手塩
てした	手下
てじな	手品
てじゅん	手順
てじょう	手錠
てすう	手数
てすじ	手筋
てせい	手製
てぜい	手勢
てぜま	手狭
てそう	手相
てだい	手代
てだま	手玉
てぢか	手近
てちょう	手帳
てっかい	撤回
てつがく	哲学
てっかん	鉄管
てっき	鉄器
てっきょ	撤去
てっきょう	鉄橋
てっきん	鉄筋
てっけん	徹見
てっけん	鉄拳
てっこう	鉄工
てっこう	鉄鉱
てっこう	鉄鋼
てっこく	敵国
てっこつ	鉄骨
てっしゅう	撤収
てっしょう	徹宵
てつじょう	鉄条
てつじん	哲人
てっせい	鉄製
てっせん	鉄線
てっそく	鉄則
てったい	撤退
でっち	丁稚
てってい	徹底
てっとう	鉄塔
てつどう	鉄道
てっぱい	撤廃
てっぱん	鉄板
てっぴつ	鉄筆
てつびん	鉄瓶
てっぺい	撤兵
てっぺき	鉄壁
てっぽう	鉄砲
てつぼう	鉄棒
てつや	徹夜
てつり	哲理
てづる	手蔓
てておや	父親
でどころ	出所
てなみ	手並
では	では
てはい	手配
てばた	手旗
てばや	手速
でぶ	でぶ
てぶくろ	手袋
でふね	出船
てほん	手本
てま	手間
でま	デマ
てまえ	手前
でまえ	出前
でまど	出窓
でみず	出水
でみせ	出店
でも	でも
でも	デモ
てり	照り
てる	照る
でる	出る
でんあつ	電圧
てんい	天意
てんい	転位
てんい	転移
でんい	電位
てんいん	店員
でんえん	田園
てんか	天下
てんか	添加
てんか	転化
てんか	転嫁
てんか	転訛
てんか	点火
てんが	典雅
でんか	殿下
でんか	電化
てんかい	展開
てんかい	転回
でんかい	電解
てんかく	点画
でんがく	田楽
てんかん	転換
てんかん	癲癇
てんき	天気
てんき	転機
てんき	転記
でんき	伝記
でんき	電機
でんき	電気
でんきゅう	電球
てんきょ	典拠
てんきょ	転居
てんぎょう	転業
でんきょく	電極
てんきん	転勤
てんぐ	天狗
てんくう	天空
てんけい	典型
てんけい	点景
でんげき	電撃
てんけん	天険
てんけん	点検
でんけん	電鍵
でんげん	電源
てんこ	点呼
てんこう	天候
てんこう	転向
てんこう	転校
でんこう	電光
でんこう	電工
てんごく	天国
でんごん	伝言
てんさ	点差
てんさい	天才
てんさい	天災
てんさい	転載
てんざい	点在
てんさく	添削
てんし	天使
てんし	天子
てんじ	展示
てんじ	点字
でんし	電子
でんじ	田地
てんじく	天竺
てんしゃ	転写
でんしゃ	電車
てんしゅ	天主
てんしゅ	店主
てんじゅ	天寿
でんじゅ	伝授
てんしゅつ	転出
てんしょ	添書
てんしょう	天象
てんじょう	天井
てんじょう	天上
でんしょう	伝承
てんしょく	天職
てんしょく	転職
てんしん	天心
てんじん	天神
でんしん	電信
てんすい	天水
てんすう	点数
てんせい	天性
てんせい	転成
でんせつ	伝説
てんせん	転戦
てんせん	点線
でんせん	伝染
でんせん	電線
てんそう	転漕
てんそう	転送
でんそう	電装
でんそう	電送
てんそく	天測
てんたい	天体
てんたく	転宅
でんたつ	伝達
てんたん	恬淡
でんたん	電探
てんち	天地
てんち	転地
でんち	田地
でんち	電池
でんちく	電蓄
でんちゅう	電柱
てんちょう	天頂
てんちょう	転調
てんてき	点滴
でんてつ	電鉄
てんてん	転々
てんてん	点々
てんとう	店頭
てんとう	転倒
てんとう	点燈
でんとう	伝統
でんとう	電燈
でんどう	伝導
でんどう	伝道
でんどう	殿堂
てんどん	天丼
てんにゅう	転入
てんにょ	天女
てんにん	天人
てんにん	転任
でんねつ	電熱
てんねん	天然
てんのう	天皇
でんぱ	伝播
でんぱ	電波
でんぱた	田畑
てんばつ	天罰
てんぱん	典範
てんぴ	天日
てんびょう	点描
でんぴょう	伝票
てんびん	天秤
てんぷ	添付
てんぷく	転覆
てんぶん	天分
でんぶん	伝聞
でんぶん	電文
でんぷん	澱粉
てんぺん	転変
てんぼ	展墓
てんぽ	填補
てんぽ	店舗
てんぼう	展望
でんぽう	電報
てんまく	天幕
てんまつ	顛末
てんめい	天命
てんめつ	点滅
てんもん	天文
でんや	田野
てんゆう	天佑
でんらい	伝来
てんらく	転落
てんらん	展覧
てんり	天理
でんり	電離
でんりゅう	電流
でんりょく	電力
てんれい	典麗
でんれい	伝令
でんれい	電鈴
てんろ	転炉
でんわ	電話
どあ	ドア
どあい	度合
とい	問い
といき	吐息
といし	砥石
といた	戸板
といや	問屋
とう	とう
とう	訪う
とう	問う
どう	どう
とうあん	答案
とうい	当為
どうい	同位
どうい	同意
とういつ	統一
どういつ	同一
とういん	党員
とういん	頭韻
どういん	動員
とうえい	投影
とうおう	東欧
どうおん	同音
とうか	投下
とうか	燈火
どうか	同化
どうか	銅貨
とうかい	倒壊
とうかい	韜晦
とうがい	当該
とうがい	等外
とうかく	倒閣
とうかく	統覚
とうかく	頭角
どうかく	同格
どうがく	同学
どうがく	同額
とうかつ	統括
とうかん	投函
とうかん	等閑
どうかん	同感
どうがん	童顔
とうき	登記
とうき	冬季
とうき	投機
とうき	陶器
とうき	騰貴
とうぎ	討議
とうぎ	闘技
どうき	動機
どうき	動悸
どうき	同期
どうき	銅器
どうぎ	動議
どうぎ	同義
どうぎ	道義
とうきゅう	投球
とうきゅう	等級
とうきゅう	討究
とうぎゅう	闘牛
どうきゅう	同級
どうきゅう	撞球
とうぎょ	統御
どうきょ	同居
どうきょう	同郷
どうぎょう	同業
どうぎょう	同行
とうきょく	当局
どうきん	同衾
どうぐ	道具
とうぐう	東宮
どうくつ	洞窟
どうくん	同君
どうけ	道化
とうけい	刀圭
とうけい	東経
とうけい	統計
とうけい	闘鶏
どうけい	同形
どうけい	同系
どうけい	憧憬
とうけつ	凍結
どうけつ	洞穴
とうけん	刀剣
とうけん	闘犬
とうげん	桃源
どうけん	同権
とうこう	登校
とうこう	刀工
とうこう	投稿
とうこう	投降
とうこう	陶工
とうごう	投合
とうごう	統合
どうこう	動向
どうこう	同好
どうこう	同行
どうこう	瞳孔
とうごく	投獄
とうごく	東国
どうこく	同国
とうこん	当今
とうこん	闘魂
とうさ	踏査
とうざ	当座
どうさ	動作
とうさい	搭載
とうさい	当歳
とうざい	東西
とうさん	倒産
とうざん	当山
どうさん	動産
どうざん	銅山
とうし	凍死
とうし	唐詩
とうし	投資
とうし	透視
とうし	闘士
とうし	闘志
とうじ	冬至
とうじ	湯治
とうじ	当事
とうじ	当時
とうじ	答辞
どうし	動詞
どうし	同士
どうし	同志
どうし	同氏
どうじ	同時
とうしき	等式
とうしつ	等質
とうじつ	当日
どうしつ	同室
どうしつ	同質
どうじつ	同日
とうしゃ	投射
とうしゃ	当社
とうしゃ	謄写
どうしゃ	同社
どうしゃ	同車
とうしゅ	党首
とうしゅ	投手
どうしゅ	同種
とうしゅう	踏襲
どうしゅく	同宿
とうしょ	投書
とうしょ	当初
とうしょう	凍傷
とうじょう	登場
とうじょう	搭乗
どうじょう	同上
どうじょう	同乗
どうじょう	同情
どうじょう	道場
どうしょく	同色
とうしん	投身
とうしん	東進
とうしん	燈心
とうしん	答申
とうしん	頭身
とうじん	蕩尽
どうしん	同心
どうしん	童心
どうしん	道心
どうじん	同人
とうすい	統帥
とうすい	陶酔
どうすう	同数
どうすん	同寸
とうせい	当世
とうせい	統制
どうせい	動静
どうせい	同姓
どうせい	同性
どうせい	同棲
どうぜい	同勢
とうせき	投石
どうせき	同席
とうせつ	当節
とうせん	当選
とうぜん	東漸
とうぜん	当然
とうぜん	陶然
どうせん	同船
どうせん	銅線
どうぜん	同然
とうそう	刀槍
とうそう	逃走
とうそう	闘争
どうそう	同窓
どうぞう	銅像
とうぞく	盗賊
どうぞく	同族
とうそつ	統率
どうそん	同村
とうだい	燈台
とうだい	当代
どうたい	動態
どうたい	導体
どうたい	胴体
とうたつ	到達
とうだん	登壇
どうだん	同断
とうち	倒置
とうち	当地
とうち	統治
とうちゃく	到着
とうちゅう	頭注
どうちゅう	道中
とうちょう	登庁
とうちょう	盗聴
どうちょう	同調
とうちょく	当直
とうてい	到底
どうてい	同定
どうてい	童貞
どうてい	道程
とうてき	投擲
どうてき	動的
とうてん	読点
とうでん	盗電
どうてん	同点
とうど	陶土
とうとい	貴い
とうとう	〓鞳
とうとう	等々
とうとう	滔々
どうとう	同等
どうとう	道統
どうどう	同道
どうどう	堂々
どうとく	道徳
とうとつ	唐突
とうとぶ	尊ぶ
とうない	党内
とうなん	東南
とうなん	盗難
とうにゅう	投入
どうにゅう	導入
とうにん	当人
どうにん	同人
とうねん	当年
どうねん	同年
とうの	当の
とうは	党派
とうは	踏破
どうはい	同輩
とうはつ	頭髪
とうばつ	盗伐
とうばつ	討伐
とうはん	登攀
とうばん	登板
とうばん	当番
どうはん	同伴
どうばん	銅版
とうひ	当否
とうひ	等比
とうひ	逃避
とうひょう	投票
とうびょう	投錨
とうびょう	痘苗
とうびょう	闘病
どうひょう	道標
どうびょう	同病
とうひん	盗品
とうふ	豆腐
とうぶ	東部
とうぶ	頭部
どうふう	同封
どうぶつ	動物
とうぶん	当分
とうぶん	等分
とうぶん	糖分
どうぶん	同文
とうへき	盗癖
とうへん	等辺
とうべん	答弁
とうほう	東方
とうほう	当方
とうぼう	逃亡
どうほう	同胞
とうほく	東北
とうほん	謄本
どうみゃく	動脈
とうみょう	燈明
とうみん	冬眠
とうめい	透明
どうめい	同盟
とうめん	当面
どうもう	獰猛
とうや	陶冶
とうやく	投薬
とうゆ	燈油
とうよう	登用
とうよう	東洋
とうよう	盗用
とうよう	当用
どうよう	動揺
どうよう	同様
どうよう	童謡
どうよく	胴欲
とうらい	到来
どうらく	道楽
どうらん	動乱
どうり	道理
とうりつ	倒立
とうりゅう	逗留
とうりょう	棟梁
とうりょう	等量
どうりょう	同僚
どうりょう	同量
どうりょく	動力
とうるい	盗塁
どうるい	同類
とうれい	答礼
どうれつ	同列
どうろ	道路
とうろう	燈篭
とうろく	登録
とうろん	討論
どうわ	童話
とうわく	当惑
とお	とお
とおあさ	遠浅
とおい	遠い
とおう	渡欧
とおえん	遠縁
とおく	遠く
とおし	通し
とおす	通す
とおで	遠出
とおみ	遠見
とおめ	遠目
とおやま	遠山
とおり	通り
とおる	通る
とおる	透る
とか	渡河
とか	都下
とが	とが
とかい	都会
どかい	土塊
どかた	土方
どかん	土管
どき	土器
どき	怒気
ときおり	時折
ときどき	時々
ときに	時に
どぎも	度胆
ときよ	時世
どきょう	度胸
とく	解く
とく	疾く
とく	説く
とく	溶く
とぐ	研ぐ
どく	どく
とくい	得意
とくい	特異
とくいく	徳育
どぐう	土偶
どくえん	独演
どくおう	独往
とくがく	篤学
どくがく	独学
とくぎ	徳義
とくぎ	特技
どくけ	毒気
どくご	独語
どくご	読後
とくざい	贖罪
どくさい	独裁
とくさく	得策
どくさつ	毒殺
とくさん	特産
とくし	特使
とくし	篤志
どくじ	独自
とくしつ	得失
とくしつ	特質
とくじつ	篤実
とくしゃ	特赦
どくしゃ	読者
どくしゃく	独酌
とくしゅ	特殊
とくじゅ	特需
とくしゅう	特輯
とくしゅう	特集
どくしゅう	独習
どくしょ	読書
どくしょう	独唱
とくしょく	涜職
とくしょく	特色
とくしん	得心
どくしん	独身
とくせい	徳性
とくせい	徳政
とくせい	特性
とくせい	特製
とくせつ	特設
どくぜつ	毒舌
とくせん	特選
どくせん	独占
どくぜん	独善
どくそ	毒素
どくそう	毒草
どくそう	独創
どくそう	独奏
どくそう	独走
とくそく	督促
どくだん	独断
とぐち	戸口
とくちょう	特徴
とくちょう	特長
とくてい	特定
とくてん	得点
とくてん	特典
とくでん	特電
とくと	篤と
とくど	得度
とくとう	特等
とくとく	得々
どくとく	独特
とくに	特に
とくのう	篤農
とくは	特派
どくは	読破
とくはい	特配
とくばい	特売
どくはく	独白
とくひつ	特筆
とくひょう	得票
どくぶつ	毒物
とくべつ	特別
とくほう	特報
とくぼう	徳望
とくほん	読本
どくみ	毒見
どくむし	毒虫
とくめい	匿名
とくめい	特命
とくやく	特約
どくやく	毒薬
とくゆう	特有
とくよう	徳用
とくり	徳利
どくりつ	独立
どくりょく	独力
とくれい	特例
とくれい	督励
どくろ	髑髏
とげ	とげ
とけい	時計
とけい	徒刑
とけつ	吐血
どけん	土建
とこ	とこ
どこ	どこ
どご	土語
とこう	渡航
どこう	土工
どごう	怒号
とこなつ	常夏
とこや	床屋
とこやみ	常闇
とこよ	常世
ところてん	心太
とさつ	屠殺
とざま	外様
とざん	登山
とし	都市
とじ	途次
とじ	刀自
どし	同士
としうえ	年上
としご	年子
としした	年下
どしつ	土質
としつき	年月
としどし	年々
としなみ	年波
としのくれ	歳暮
としは	年端
としばい	年配
としま	年増
どしゃ	土砂
としゅ	徒手
としょ	図書
としょう	渡渉
とじょう	途上
どじょう	土壌
としょく	徒食
としよわ	年弱
としん	都心
どじん	土人
どすう	度数
とせい	渡世
どせい	土星
とぜつ	途絶
とせん	渡船
とそ	屠蘇
とそう	塗装
どそう	土葬
どぞう	土蔵
どそく	土足
どぞく	土俗
どだい	土台
とだな	戸棚
とたん	塗炭
とたん	途端
とち	土地
どちゃく	土着
とちゅう	途中
どちゅう	土中
とっか	徳化
とっか	特価
とっかん	突貫
とっき	突起
どっき	毒気
とっきゅう	特急
とっきゅう	特級
とっきょ	特許
とつぐ	嫁ぐ
とつくに	外国
とつげき	突撃
とっけん	特権
とっこう	特効
とっこう	特攻
とっこう	篤行
とっしゅつ	突出
とつじょ	突如
とっしん	突進
とつぜん	突然
とったん	突端
とって	把手
とってい	突堤
とつにゅう	突入
とっぱ	突破
とっぱつ	突発
とっぱな	突端
とっぱん	凸版
とっぴ	突飛
とっぷう	突風
とつべん	訥弁
どっぽ	独歩
どて	土手
とてい	徒弟
ととう	徒党
どとう	怒涛
とどく	届く
とどけ	届け
とどこおり	滞り
とどこおる	滞る
ととのう	整う
とない	都内
となりぐみ	隣組
となる	隣る
どの	どの
どのう	土嚢
とのがた	殿方
とのご	殿御
とのさま	殿様
とばく	賭博
どばし	土橋
とはん	登攀
とび	とび
とびいろ	鳶色
とびぐち	鳶口
とびしょく	鳶職
どひょう	土俵
どびん	土瓶
とふ	塗布
とぶ	飛ぶ
どぶ	どぶ
とぶくろ	戸袋
とふつ	渡仏
とぶらう	弔う
とべい	渡米
どべい	土塀
とほ	徒歩
とほう	途方
どぼく	土木
どま	土間
とまり	泊り
とみに	頓に
どみん	土民
とむ	富む
とむらう	弔う
とめ	止め
とも	とも
ども	ども
ともいろ	共色
ともぬの	共布
どもり	吃り
とや	鳥屋
どよう	土曜
どよう	土用
とら	とら
どら	どら
とらい	渡来
とり	取り
とりい	鳥居
とりつ	都立
とりひき	取引
とりめ	鳥目
とりょう	塗料
どりょう	度量
どりょく	努力
とる	とる
とる	撮る
とる	執る
とる	取る
どる	ドル
どれ	どれ
どれい	奴隷
とろ	吐露
どろあし	泥足
とろう	徒労
どろうみ	泥海
どろぐつ	泥靴
どろた	泥田
どろつち	泥土
どろなわ	泥繩
どろぬま	泥沼
どろぼう	泥坊
どろみず	泥水
とん	トン
どん	どん
どん	ドン
どんかく	鈍角
どんかん	鈍感
とんきょう	頓狂
とんご	頓悟
とんざ	頓挫
とんさい	頓才
どんさい	鈍才
とんし	頓死
とんじ	豚児
とんじ	遁辞
とんじゃく	頓着
とんしゅ	頓首
どんじゅう	鈍重
とんせい	遁世
とんそう	遁走
とんち	頓知
とんちゃく	頓着
どんつう	鈍痛
どんてん	曇天
とんぷく	頓服
とんや	問屋
どんよく	貪欲
どんらん	貪婪
なあ	なあ
ない	ない
ないい	内意
ないえん	内縁
ないおう	内応
ないか	内科
ないかい	内海
ないがい	内外
ないかく	内角
ないかく	内閣
ないき	内規
ないぎ	内儀
ないきん	内勤
ないけん	内見
ないこう	内向
ないこう	内攻
ないこう	内訌
ないこく	内国
ないさい	内済
ないざい	内在
ないし	乃至
ないじ	内示
ないじつ	内実
ないじゅ	内需
ないしょ	内緒
ないじょ	内助
ないしょう	内証
ないじょう	内情
ないじょう	内状
ないしょく	内職
ないしん	内心
ないしん	内申
ないせい	内省
ないせい	内政
ないせつ	内接
ないせん	内戦
ないせん	内線
ないそう	内装
ないぞう	内臓
ないぞう	内蔵
ないそん	内孫
ないだく	内諾
ないだん	内談
ないち	内地
ないつう	内通
ないてい	内偵
ないてい	内定
ないない	内々
ないぶ	内部
ないふく	内服
ないふん	内紛
ないぶん	内聞
ないほう	内包
ないほう	内報
ないまく	内幕
ないみつ	内密
ないむ	内務
ないめい	内命
ないめん	内面
ないや	内野
ないやく	内約
ないよう	内容
ないよう	内用
ないらん	内乱
ないらん	内覧
なう	綯う
なえぎ	苗木
なえどこ	苗床
なお	なお
なおし	直し
なおす	治す
なおす	直す
なおる	治る
ながあめ	長雨
ながい	長い
ながい	長居
ながうた	長唄
ながえ	長柄
なかおもて	中表
なかがい	仲買
ながぐつ	長靴
ながさ	長さ
ながざ	長座
なかし	仲仕
ながし	流し
ながす	流す
ながそで	長袖
なかぞら	中空
なかだか	中高
ながなが	長々
なかにわ	中庭
ながねん	永年
ながばなし	長話
なかび	中日
なかひく	中低
なかま	仲間
なかみ	中味
ながめ	眺め
ながめ	長雨
ながや	長屋
なかゆび	中指
ながれ	流れ
なき	泣き
なき	亡き
なく	泣く
なく	鳴く
なぐ	なぐ
なぐさみ	慰み
なぐさめ	慰め
なげ	投げ
なげき	嘆き
なげく	嘆く
なげし	長押
なこうど	仲人
なごり	名残
なさけ	情け
なし	なし
なす	なす
なぜ	なぜ
なぜ	何故
なぞ	なぞ
なた	なた
なだい	名題
なたね	菜種
なついん	捺印
なつくさ	夏草
なつぐも	夏雲
なっせん	捺染
なっとう	納豆
なっとく	納得
なつば	夏場
なつもの	夏物
なつやま	夏山
などころ	名所
なな	なな
なないろ	七色
ななくさ	七草
ななせん	七千
ななひゃく	七百
ななめ	斜め
なに	なに
なにか	何か
なにごと	何事
なにせ	何せ
なになに	何々
なにぶん	何分
なにもの	何者
なにもの	何物
なにゆえ	何故
なにわ	難波
なぬし	名主
なびく	靡く
なふだ	名札
なべかま	鍋釜
なま	なま
なまうお	生魚
なまえ	名前
なまき	生木
なまぐさ	生臭
なまくび	生首
なまざかな	生魚
なまみ	生身
なまみず	生水
なみ	並み
なみおと	波音
なみがしら	波頭
なみかぜ	波風
なみき	並木
なみじ	波路
なみとう	並等
なみなみ	並々
なみま	波間
なむ	南無
なや	納屋
なやみ	悩み
なやむ	悩む
なら	なら
ならい	習い
ならく	奈落
ならす	均す
ならび	並び
ならぶ	並ぶ
なり	なり
なり	鳴り
なりきん	成金
なる	なる
なる	成る
なる	鳴る
なるこ	鳴子
なわしろ	苗代
なんい	南緯
なんい	難易
なんおう	南欧
なんか	南下
なんか	軟化
なんかい	南海
なんかい	難解
なんかん	難関
なんぎ	難儀
なんきつ	難詰
なんきゅう	軟球
なんぎょう	難行
なんきょく	南極
なんきょく	難局
なんきん	軟禁
なんくせ	難癖
なんこう	軟膏
なんこう	難航
なんごく	南国
なんこつ	軟骨
なんざん	難産
なんじ	難事
なんしき	軟式
なんじゃく	軟弱
なんじゅう	何十
なんじゅう	難渋
なんしょ	難所
なんしょく	難色
なんすい	軟水
なんせ	何せ
なんせん	難船
なんぜん	何千
なんだい	難題
なんちょう	難聴
なんてん	難点
なんど	納戸
なんにょ	男女
なんぱ	軟派
なんぱ	難破
なんばん	南蛮
なんびゃく	何百
なんびょう	難病
なんぶ	南部
なんぷう	南風
なんぷう	軟風
なんぶつ	難物
なんべい	南米
なんぽう	南方
なんぼく	南北
なんみん	難民
なんもん	難問
なんよう	南洋
なんら	何ら
なんろ	難路
にいづま	新妻
におう	仁王
にかい	二階
にがい	苦い
にがお	似顔
にがて	苦手
にがみ	苦味
にがる	苦る
にぎり	握り
にぎる	握る
にぎわう	賑う
にくい	憎い
にくがん	肉眼
にくじき	肉食
にくしょく	肉食
にくしん	肉親
にくせい	肉声
にくたい	肉体
にくはく	肉薄
にくひつ	肉筆
にくぶと	肉太
にくむ	憎む
にくや	肉屋
にくるい	肉類
にぐるま	荷車
にごす	濁す
にごり	濁り
にごる	濁る
にごん	二言
にざかな	煮魚
にさん	二三
にしかぜ	西風
にしがわ	西側
にしきえ	錦絵
にしきた	西北
にしび	西日
にじゅう	二十
にじゅう	二重
にしん	二伸
にしん	二心
にす	ニス
にせ	にせ
にせい	二世
にせん	二千
にそう	尼僧
にちげつ	日月
にちげん	日限
にちじ	日時
にちじょう	日常
にちにち	日々
にちぶ	日舞
にちべい	日米
にちぼつ	日没
にちや	日夜
にちよう	日曜
にちよう	日用
にちりん	日輪
にっか	日課
にっかん	日刊
にっき	日記
にっきゅう	日給
にっこう	日光
にっさん	日参
にっさん	日産
にっし	日誌
にっしょく	日食
にっすう	日数
にっせき	日赤
にっそ	日ソ
にっちゅう	日中
にっちょう	日長
にっちょく	日直
にってい	日程
にっとう	日当
にっぽう	日報
にっぽん	日本
にぬし	荷主
にひゃく	二百
にぶい	鈍い
にふだ	荷札
にぶる	鈍る
にぶん	二分
にほん	日本
にまめ	煮豆
にもつ	荷物
にもの	煮物
にやく	荷役
にゅういん	入院
にゅうえい	入営
にゅうか	乳化
にゅうか	入荷
にゅうかい	入会
にゅうかく	入閣
にゅうがく	入学
にゅうぎゅう	乳牛
にゅうきょう	入京
にゅうきん	入金
にゅうこ	入庫
にゅうこう	入校
にゅうこう	入港
にゅうこう	入貢
にゅうこく	入国
にゅうごく	入獄
にゅうざい	乳剤
にゅうさつ	入札
にゅうし	乳歯
にゅうし	入試
にゅうじ	乳児
にゅうしゃ	入社
にゅうじゃく	柔弱
にゅうしゅ	入手
にゅうしょ	入所
にゅうしょう	入賞
にゅうじょう	乳状
にゅうじょう	入城
にゅうじょう	入場
にゅうしょく	入植
にゅうしん	入神
にゅうせき	入籍
にゅうせん	入選
にゅうそ	入ソ
にゅうたい	入隊
にゅうちょう	入超
にゅうてい	入廷
にゅうでん	入電
にゅうとう	入党
にゅうとう	入湯
にゅうどう	入道
にゅうねん	入念
にゅうばい	入梅
にゅうひ	入費
にゅうまく	入幕
にゅうもん	入門
にゅうよう	入用
にゅうよく	入浴
にゅうわ	柔和
にょうどく	尿毒
にょうぼう	女房
にょかん	女官
にょじつ	如実
にょしょう	女性
にょにん	女人
にょらい	如来
にら	にら
にる	似る
にる	煮る
にるい	二塁
にれ	にれ
にわいし	庭石
にわき	庭木
にわくさ	庭草
にわさき	庭先
にわし	庭師
にんい	任意
にんか	認可
にんかん	任官
にんき	人気
にんき	任期
にんきょう	任侠
にんぎょう	人形
にんく	忍苦
にんげん	人間
にんしき	認識
にんじゅつ	忍術
にんしょう	人称
にんしょう	認証
にんじょう	人情
にんじょう	刃傷
にんしん	妊娠
にんず	人数
にんずう	人数
にんそう	人相
にんそく	人足
にんたい	忍耐
にんち	任地
にんち	認知
にんてい	認定
にんとく	人徳
にんぷ	人夫
にんぷ	妊婦
にんむ	任務
にんめい	任命
にんめん	任免
にんよう	任用
ぬい	縫い
ぬう	縫う
ぬえ	ぬえ
ぬき	抜き
ぬく	抜く
ぬぐ	脱ぐ
ぬぐう	拭う
ぬけ	抜け
ぬし	ぬし
ぬすっと	盗人
ぬすびと	盗人
ぬすみ	盗み
ぬすむ	盗む
ぬの	ぬの
ぬのじ	布地
ぬのめ	布目
ぬまち	沼地
ぬり	塗り
ぬる	塗る
ねあせ	寝汗
ねいき	寝息
ねいろ	音色
ねえ	ねえ
ねが	ネガ
ねがい	願い
ねがう	願う
ねがお	寝顔
ねぎ	ねぎ
ねこ	ねこ
ねごと	寝言
ねじ	ねじ
ねじろ	根城
ねずみいろ	鼠色
ねぞう	寝相
ねた	ねた
ねだい	寝台
ねだん	値段
ねつあい	熱愛
ねつい	熱意
ねつえん	熱演
ねっき	熱気
ねっきょう	熱狂
ねっけつ	熱血
ねつじょう	熱情
ねっしん	熱心
ねっせい	熱誠
ねっせん	熱戦
ねっせん	熱線
ねつぞう	捏造
ねったい	熱帯
ねっちゅう	熱中
ねつど	熱度
ねっとう	熱湯
ねつびょう	熱病
ねっぷう	熱風
ねつべん	熱弁
ねつぼう	熱望
ねつりょう	熱量
ねつるい	熱涙
ねつれつ	熱烈
ねどこ	寝床
ねばり	粘り
ねばる	粘る
ねはん	涅槃
ねぼう	寝坊
ねま	寝間
ねむい	眠い
ねむけ	眠気
ねむり	眠り
ねむる	眠る
ねもと	根元
ねり	練り
ねる	ネル
ねる	寝る
ねる	練る
ねんえき	粘液
ねんが	年賀
ねんがく	年額
ねんかん	年鑑
ねんかん	年間
ねんがん	念願
ねんき	年忌
ねんき	年期
ねんき	年季
ねんきん	年金
ねんぐ	年貢
ねんげつ	年月
ねんげん	年限
ねんこう	年功
ねんごう	年号
ねんざ	捻挫
ねんさん	年産
ねんし	年始
ねんじ	年時
ねんじ	年次
ねんしゅう	年収
ねんじゅう	年中
ねんしょう	年少
ねんしょう	燃焼
ねんすう	年数
ねんだい	年代
ねんちゃく	粘着
ねんちょう	年長
ねんど	年度
ねんど	粘土
ねんとう	年頭
ねんとう	念頭
ねんない	年内
ねんねん	年々
ねんぱい	年配
ねんぴょう	年表
ねんぷ	年譜
ねんぶつ	念仏
ねんぽう	年俸
ねんぽう	年報
ねんまく	粘膜
ねんまつ	年末
ねんらい	年来
ねんり	年利
ねんりき	念力
ねんりょう	燃料
ねんりん	年輪
ねんれい	年齢
のうえん	濃艶
のうえん	脳炎
のうえん	農園
のうか	農家
のうか	農科
のうがく	能楽
のうがく	農学
のうかん	納棺
のうかん	農閑
のうき	納期
のうきょう	農協
のうぎょう	農業
のうきん	納金
のうぐ	農具
のうげい	農芸
のうこう	濃厚
のうこう	農工
のうこう	農耕
のうこう	農高
のうこつ	納骨
のうさく	農作
のうさつ	悩殺
のうし	農試
のうじ	農事
のうしゅ	膿腫
のうしゅく	濃縮
のうしょ	能書
のうしょう	脳漿
のうしょう	農相
のうじょう	農場
のうずい	脳髄
のうせい	農政
のうぜい	納税
のうそん	農村
のうたん	濃淡
のうち	農地
のうてん	脳天
のうど	濃度
のうど	農奴
のうどう	能動
のうにゅう	納入
のうはん	農繁
のうひつ	能筆
のうひん	納品
のうふ	納付
のうふ	農夫
のうべん	能弁
のうみつ	濃密
のうみん	農民
のうむ	濃霧
のうやく	農薬
のうらん	悩乱
のうり	脳裏
のうり	脳裡
のうりつ	能率
のうりょう	納涼
のうりょく	能力
のうりん	農林
のお	ノー
のきさき	軒先
のきした	軒下
のきなみ	軒並
のきば	軒端
のく	のく
のこ	のこ
のこす	残す
のこり	残り
のこる	残る
のし	のし
のじゅく	野宿
のす	のす
のぞき	覗き
のぞく	除く
のぞく	覗く
のぞみ	望み
のぞむ	望む
のぞむ	臨む
のちざん	後産
のちのち	後々
のてん	野天
のど	のど
ののしり	罵り
のはら	野原
のび	伸び
のび	野火
のべ	延べ
のべ	野辺
のぼり	上り
のみ	のみ
のみ	呑み
のむ	飲む
のやま	野山
のら	野ら
のり	のり
のり	乗り
のりしろ	糊代
のりと	祝詞
のる	乗る
のわき	野分
はあ	はあ
ばあ	ばあ
ばあ	バー
ぱあ	パー
ばあい	場合
はあく	把握
はい	はい
はいいろ	灰色
はいいん	敗因
ばいいん	売淫
ばいう	梅雨
はいえい	背泳
はいえつ	拝謁
はいえん	肺炎
ばいえん	煤煙
はいおく	廃屋
はいか	廃家
はいか	配下
はいが	拝賀
はいが	胚芽
ばいか	倍加
ばいか	梅花
ばいか	売価
はいかい	徘徊
はいがい	排外
ばいかい	媒介
ばいがく	倍額
はいかん	廃刊
はいかん	拝観
はいかん	配管
はいがん	拝顔
はいき	廃棄
はいき	排気
ばいきゃく	売却
はいきゅう	排球
はいきゅう	配給
はいきょ	廃墟
はいぎょう	廃業
ばいきん	黴菌
はいく	俳句
はいぐん	敗軍
はいけい	拝啓
はいけい	背景
はいげき	排撃
はいけん	拝見
はいご	廃語
はいご	背後
はいこう	廃坑
はいこう	廃校
はいごう	廃合
はいごう	配合
ばいこく	売国
はいざい	配剤
はいざら	灰皿
はいざん	敗残
はいし	廃止
はいじ	拝辞
はいしゃ	拝謝
はいしゃ	敗者
はいしゃ	配車
はいしゃく	拝借
ばいしゃく	媒酌
はいじゅ	拝受
ばいしゅう	買収
はいしゅつ	排出
はいしゅつ	輩出
ばいしゅん	売春
はいしょ	配所
はいじょ	廃除
はいじょ	排除
はいしょう	廃娼
はいしょう	拝誦
ばいしょう	売笑
ばいしょう	賠償
はいしょく	配色
はいしん	背信
はいじん	俳人
はいじん	廃人
ばいしん	陪審
はいすい	排水
はいすい	配水
ばいすう	倍数
はいせき	排斥
ばいせき	陪席
はいせつ	排泄
はいせん	廃船
はいせん	敗戦
はいせん	肺尖
はいせん	配線
はいせん	配船
はいぜん	配膳
はいぜん	沛然
はいそ	敗訴
はいそう	敗走
はいぞう	肺臓
ばいぞう	倍増
はいぞく	配属
はいた	排他
はいたい	廃頽
はいたい	敗退
はいたい	胚胎
ばいだい	倍大
はいたつ	配達
はいだん	俳壇
はいち	背馳
はいち	配置
はいちゃく	廃嫡
はいちょう	拝聴
はいでん	拝殿
はいでん	配電
ばいてん	売店
はいとう	配当
はいとく	背徳
はいどく	拝読
ばいどく	梅毒
はいにち	排日
はいにん	背任
はいのう	背嚢
ばいばい	売買
はいはん	背反
はいびょう	肺病
はいひん	廃品
ばいひん	売品
はいふ	配付
はいふ	配布
はいぶ	背部
はいふく	拝復
はいぶつ	廃物
はいぶん	配分
ばいぶん	売文
はいへい	廃兵
はいべん	排便
ばいべん	買弁
はいぼく	敗北
はいほん	配本
はいみ	俳味
ばいめい	売名
はいめん	背面
はいやく	配役
ばいやく	売約
ばいやく	売薬
はいゆう	俳優
ばいよう	培養
ばいりつ	倍率
はいりょ	配慮
ばいりょう	倍量
はいれい	拝礼
はいれつ	排列
はいれつ	配列
はう	はう
はう	這う
はえ	はえ
はえ	映え
はおと	羽音
はおり	羽織
ばか	ばか
ばか	馬鹿
はかい	破壊
はかい	破戒
はかいし	墓石
はがき	葉書
はかく	破格
はかしょ	墓所
ばかず	場数
はかせ	博士
はかどころ	墓所
はかば	墓場
はかぶ	端株
はかり	計り
はかる	計る
はかる	図る
はかる	測る
はかる	謀る
はかる	量る
はき	覇気
はき	破棄
はぎ	はぎ
はぎ	接ぎ
ばきゃく	馬脚
はきゅう	波及
はぎょう	覇業
はきょく	破局
はく	はく
はく	掃く
はく	吐く
はぐ	はぐ
はぐ	剥ぐ
ばぐ	馬具
はくあい	博愛
はくい	白衣
はくうん	白雲
ばくおん	爆音
はくが	博雅
ばくが	麦芽
はくがい	迫害
はくがく	博学
はくげい	白鯨
はくげき	迫撃
ばくげき	爆撃
ばくさい	爆砕
はくし	博士
はくし	白紙
はくし	薄志
はくしき	博識
はくじつ	白日
はくしゃ	拍車
はくしゃ	薄謝
はくしゃく	伯爵
はくじゃく	薄弱
はくしゅ	拍手
ばくしゅう	麦秋
はくしょ	白書
ばくしょ	曝書
はくじょう	白状
はくじょう	薄情
ばくしょう	爆笑
はくしょく	白色
はくじん	白人
はくじん	白刃
ばくしん	爆心
ばくしん	驀進
はくすう	搏数
はくせい	剥製
はくせつ	白雪
はくせん	白線
ばくぜん	漠然
ばくだい	莫大
ばくだん	爆弾
はくち	泊地
はくち	白痴
はくちゅう	伯仲
はくちゅう	白昼
ばくちん	爆沈
ばくと	博徒
はくねつ	白熱
ばくは	爆破
はくはつ	白髪
ばくはつ	爆発
ばくはん	麦飯
はくび	白眉
はくひょう	白票
はくひょう	薄氷
はくふ	白布
ばくふ	幕府
ばくふ	瀑布
ばくふう	爆風
はくぶつ	博物
はくぼ	薄暮
はくぼく	白墨
はくまい	白米
ばくまつ	幕末
はくめい	薄命
ばくやく	爆薬
はくらい	舶来
はくらん	白卵
はくり	薄利
ばくりょう	曝涼
ばくりょう	幕僚
はくりょく	迫力
はぐるま	歯車
はくろ	白露
ばくろ	暴露
ばくろん	駁論
はけ	はけ
ばけ	化け
はげみ	励み
はげむ	励む
はげやま	禿山
はけん	覇権
はけん	派遣
ばけん	馬券
はこにわ	箱庭
はこび	運び
はこぶ	運ぶ
はこぶね	箱舟
はごろも	羽衣
はさい	破砕
はさむ	挾む
はさむ	鋏む
はさん	破産
はさん	破算
はし	はし
はじき	弾き
はしご	梯子
はしばこ	箸箱
はじめ	始め
はじめ	初め
はしゃ	霸者
ばしゃ	馬車
はしゅ	播種
はしゅつ	派出
ばじゅつ	馬術
ばしょ	場所
はじょう	波状
ばじょう	馬上
はしり	走り
はしる	走る
はす	はす
はず	はず
ばす	バス
ぱす	パス
はすう	端数
ばすえ	場末
はすっぱ	蓮葉
はずみ	弾み
はぜ	はぜ
はせい	派生
ばぞく	馬賊
はそん	破損
はた	はた
はだ	はだ
はたいろ	旗色
はだいろ	肌色
はたがしら	旗頭
はだぎ	肌着
はたざお	旗竿
はたさく	畑作
はだざむ	肌寒
はたじるし	旗印
はたび	旗日
はたらき	働き
はたらく	働く
はたん	破綻
はだん	破談
はち	はち
はちく	破竹
はちく	八九
はちじゅう	八十
はちぶ	八分
はちまん	八幡
はちみつ	蜂蜜
はちょう	ハ調
はちょう	波長
はちょう	破調
はっ	はっ
ばつ	ばつ
はつあき	初秋
はつあん	発案
はつい	発意
はついく	発育
はつうま	初午
ばつえい	末裔
はつえき	発駅
はつお	初穂
はつおん	発音
はつおん	撥音
はっか	発火
はつが	発芽
はっかい	発会
はっかく	発覚
はっかん	発刊
はっかん	発汗
はっき	白旗
はっき	発揮
はつぎ	発議
はっきゅう	薄給
はっきょう	発狂
はっきん	白金
はっきん	発禁
ばっきん	罰金
はっくつ	発掘
ばつぐん	抜群
はっけ	八卦
はっけん	発見
はつげん	発言
ばっこ	跋扈
はつこい	初恋
はっこう	薄幸
はっこう	八紘
はっこう	発光
はっこう	発効
はっこう	発行
はっこう	発酵
はっこつ	白骨
はっこん	発根
ばっさい	伐採
はっさん	発散
ばっし	末子
はつしも	初霜
はっしゃ	発射
はっしゃ	発車
はっしょう	発祥
はつじょう	発情
ばっしょう	跋渉
はっしん	発信
はっしん	発疹
ばっすい	抜粋
はっせい	発生
はっせい	発声
ばっせき	末席
はっせん	八千
はっそう	発想
はっそう	発走
はっそう	発送
はっそく	発足
ばっそく	罰則
ばっそん	末孫
はったつ	発達
はっちゃく	発着
はっちゅう	発注
ばってい	末弟
ばってき	抜擢
はってん	発展
はつでん	発電
ばってん	罰点
はっと	法度
はつどう	発動
はつなつ	初夏
はつに	初荷
はつね	初音
はつねつ	発熱
はつば	発馬
はつばい	発売
はつはる	初春
はっぴ	法被
はつひ	初日
はっぴゃく	八百
はっぴょう	発表
はつびょう	発病
はっぷ	発布
はつふゆ	初冬
はっぷん	発憤
はつほ	初穂
はっぽう	八方
はっぽう	発砲
はつまご	初孫
はつみみ	初耳
はつめい	発明
はつもの	初物
はつもん	発問
はつゆき	初雪
はつゆめ	初夢
はつよう	発揚
はつらつ	発剌
はつれい	発令
はつろ	発露
はて	はて
はて	果て
はで	はで
ばてい	馬丁
ばてい	馬蹄
はと	はと
はとう	波涛
はとう	波頭
はどう	覇道
はどう	波動
ばとう	罵倒
はな	はな
はないき	鼻息
はなうた	鼻歌
はなお	鼻緒
はながた	花形
はながみ	鼻紙
はなぐすり	鼻薬
はなげ	鼻毛
はなごえ	鼻声
はなごよみ	花暦
はなさき	鼻先
はなしる	鼻汁
はなす	放す
はなす	離す
はなす	話す
はなぞの	花園
はなたば	花束
はなぢ	鼻血
はなつ	放つ
はなばしら	鼻柱
はなばたけ	花畑
はなび	花火
はなふだ	花札
はなふだ	花礼
はなみ	花見
はなみず	鼻水
はなみち	花道
はなむこ	花婿
はなよめ	花嫁
はなれ	離れ
はなわ	花輪
はなわ	鼻輪
ばにく	馬肉
はにわ	埴輪
はね	はね
はね	羽根
ばね	ばね
はは	はは
ばば	ばば
ばば	馬場
ぱぱ	パパ
ははうえ	母上
ははおや	母親
ははかた	母方
ははぎみ	母君
はばつ	派閥
ばひつ	馬匹
ばひょう	馬標
はふ	破風
はぶく	省く
ばふん	馬糞
はへい	派兵
はへん	破片
はほん	端本
はまき	葉巻
はまべ	浜辺
はむ	ハム
はめ	羽目
はめ	破目
はめつ	破滅
ばめん	場面
はもの	刃物
はもん	波紋
はもん	破門
はや	はや
はやあし	速足
はやい	早い
はやい	速い
はやうま	早馬
はやがね	早鐘
はやく	夙く
はやく	速く
はやく	端役
はやく	破約
はやくち	早口
はやさ	速さ
はやね	早寝
はやば	早場
はやばや	早々
はやみち	早道
はやみみ	早耳
はやめ	早目
はやわざ	早業
ばら	ばら
はらい	払い
はらい	祓い
はらう	払う
はらおび	腹帯
はらげい	腹芸
はらづつみ	腹鼓
はらまき	腹巻
はらん	波瀾
はり	張り
ばり	罵詈
はりがね	針金
ばりき	馬力
はりばこ	針箱
はる	はる
はる	張る
はるあき	春秋
はるがすみ	春霞
はるかぜ	春風
はるぎ	春着
はるさき	春先
はるさめ	春雨
はれ	腫れ
はれ	晴れ
はれつ	破裂
はろう	波浪
ぱん	パン
はんい	範囲
はんえい	反映
はんえい	繁栄
はんえり	半衿
はんえん	半円
はんおん	半音
はんか	半跏
はんか	繁華
はんが	版画
ばんか	挽歌
ばんか	晩夏
はんかい	半解
はんかい	半壊
ばんかい	挽回
ばんがい	番外
はんがく	半額
ばんがく	晩学
ばんがさ	番傘
ばんがた	晩方
はんかん	反感
はんかん	繁簡
ばんかん	万感
はんき	半旗
はんき	半期
はんき	反旗
ばんぎ	板木
はんぎゃく	反逆
はんきゅう	半球
はんきょう	反共
はんきょう	反響
ばんぐみ	番組
はんけい	半径
はんげき	反撃
はんけつ	判決
はんげつ	半月
はんけん	版権
はんげん	半減
ばんけん	番犬
はんご	反語
はんこう	反抗
はんこう	犯行
はんごう	飯盒
ばんごう	番号
ばんこく	万国
ばんこん	晩婚
はんさ	煩瑣
はんざい	犯罪
ばんざい	万歳
ばんさく	万策
はんざつ	繁雑
ばんさん	晩餐
はんし	判旨
はんし	半紙
はんじ	判事
ばんじ	万事
はんした	版下
はんしゃ	反射
ばんしゃく	晩酌
ばんじゃく	磐石
はんしゅ	藩主
はんしゅう	半周
ばんしゅう	晩秋
はんじゅく	半熟
はんしゅつ	搬出
ばんしゅん	晩春
はんしょう	半焼
はんしょう	半鐘
はんしょう	反証
はんじょう	繁昌
ばんしょう	晩鐘
ばんしょう	万象
ばんしょう	万障
はんしょく	繁殖
はんしん	半身
ばんじん	蛮人
はんすう	半数
はんすう	反芻
はんせい	半生
はんせい	反省
ばんせい	伴星
ばんせい	晩成
ばんせい	蛮声
ばんせい	万世
はんせん	反戦
はんせん	帆船
はんぜん	判然
ばんぜん	万全
はんそう	帆走
はんそう	搬送
ばんそう	伴奏
ばんそう	晩霜
はんそく	反則
ばんそつ	番卒
はんそで	半袖
はんたい	反対
はんだい	飯台
はんだん	判断
ばんたん	万端
ばんち	番地
ばんち	蛮地
ばんちゃ	番茶
はんちゅう	範疇
はんつき	半月
はんてい	判定
はんてん	半天
はんてん	反転
はんてん	斑点
はんてん	班点
はんと	叛徒
はんと	版図
はんとう	半島
はんとう	反当
はんどう	反動
ばんとう	晩冬
ばんとう	番頭
はんとき	半時
はんどく	判読
はんとし	半年
ばんなん	万難
はんにち	半日
はんにゃ	般若
はんにゅう	搬入
はんにん	犯人
ばんにん	番人
ばんにん	万人
はんね	半値
はんねん	半年
ばんねん	晩年
はんのう	反応
ばんのう	万能
はんば	飯場
はんぱ	半端
はんばい	販売
はんばく	反駁
はんぱく	半白
はんばつ	藩閥
はんぱつ	反発
はんはん	半々
ばんぱん	万般
はんぷ	頒布
ばんぷう	蛮風
はんぷく	反復
ばんぶつ	万物
はんぶん	半分
はんべい	反米
ばんぺい	番兵
はんべつ	判別
はんぼう	繁忙
ばんぽう	万邦
はんまい	飯米
ばんみん	万民
はんめい	判明
ばんめし	晩飯
はんめん	半面
はんめん	反面
ばんめん	盤面
はんも	繁茂
はんもく	反目
はんもん	反問
はんもん	斑紋
はんもん	煩悶
はんやく	反訳
ばんゆう	蛮勇
ばんゆう	万有
ばんらい	万雷
はんらん	反乱
はんらん	氾濫
はんれい	判例
はんれい	凡例
はんろ	販路
はんろん	反論
はんろん	汎論
ひ	被−
ひあい	悲哀
ぴいあある	ＰＲ
びいじい	ＢＧ
ひうん	悲運
ひえ	ひえ
ひえ	冷え
ひえき	稗益
びおん	微温
びおん	微音
びおん	鼻音
ひか	皮下
ひが	彼我
びか	美化
ひがい	被害
ひかえ	控え
ひかく	比較
ひかく	皮革
びがく	美学
ひかげ	日陰
ひがさ	日傘
ひがしかぜ	東風
ひかず	日数
ひがた	干潟
ひかる	光る
ひかん	悲観
ひかん	避寒
ひがん	彼岸
ひがん	悲願
びかん	美観
ひき	引き
ひき	悲喜
ひぎ	非議
ひきゃく	飛脚
びきょ	美挙
ひきょう	卑怯
ひきょう	悲境
ひぎょう	罷業
ひきん	卑近
ひく	ひく
ひく	引く
ひく	弾く
ひく	挽く
ひく	轢く
びく	比丘
ひくい	低い
ひくつ	卑屈
ひけ	引け
ひげ	ひげ
ひげ	卑下
ひげき	悲劇
ひけつ	否決
ひけつ	秘結
ひけつ	秘訣
ひけん	比肩
ひご	ひご
ひご	卑語
ひご	庇護
ひこう	非行
ひこう	飛行
びこう	備考
びこう	尾行
びこう	微光
びこう	微行
びこう	鼻腔
ひこく	被告
ひこぼし	彦星
ひごよみ	日暦
ひざ	ひざ
びさい	微細
びざい	微罪
ひさく	秘策
ひさびさ	久々
ひざまくら	膝枕
ひさん	悲惨
ひさん	飛散
ひし	ひし
ひじ	ひじ
ひじ	秘事
ひしがた	菱形
ひじまくら	肘枕
ひしゃ	飛車
ひしゃく	柄杓
びじゃく	微弱
ひじゅう	比重
びしゅう	美醜
ひじゅつ	秘術
びじゅつ	美術
ひじゅん	批准
ひしょ	秘書
ひしょ	避暑
びじょ	美女
ひしょう	卑称
ひしょう	費消
ひしょう	飛翔
ひじょう	非常
ひじょう	非情
びしょう	微小
びしょう	微笑
びしょう	美称
びじょう	尾錠
ひしょく	非職
びしょく	美食
びしん	微震
びじん	美人
ひせい	批正
びせい	美声
ひせん	卑賎
びせん	微賎
ひそ	砒素
びそ	鼻祖
ひそう	悲壮
ひそう	悲愴
ひそう	皮相
ひぞう	秘蔵
ひぞく	卑俗
びぞく	美俗
ひそむ	潜む
ひだ	ひだ
ひたい	避退
ひだい	肥大
びたい	媚態
ひだおく	襞奥
ひたし	浸し
ひたす	浸す
ひだね	火種
ひだやま	襞山
ひだりうえ	左上
ひだりがわ	左側
ひだりて	左手
ひだりまえ	左前
ひだりよこ	左横
ひたる	浸る
ひたん	悲嘆
びだん	美談
びちゅう	微衷
ひつう	悲痛
ひっき	筆記
ひっきょう	畢竟
ひっけい	必携
ひっこう	筆耕
ひっさん	筆算
ひっし	必死
ひっし	必至
ひっし	筆紙
ひっしゃ	筆写
ひっしゃ	筆者
ひっしゅ	必須
ひつじゅ	必需
ひっしょう	必勝
ひつじょう	必定
ひっす	必須
ひっせい	畢生
ひっせい	筆勢
ひっせき	筆跡
ひつぜつ	筆舌
ひつぜん	必然
ひつだん	筆談
ひっち	筆致
ひっちゅう	筆誅
ひってき	匹敵
ひっとう	筆答
ひっとう	筆頭
ひつどく	必読
ひっぱく	逼迫
ひっぷ	匹夫
ひっぷ	匹婦
ひっぽう	筆法
ひつぼく	筆墨
ひつめい	筆名
ひつよう	必要
ひつりょく	筆力
ひつろく	筆録
ひてい	否定
びてき	美的
ひてつ	非鉄
ひでん	秘伝
びてん	美点
ひと	ひと
ひとあし	一足
ひとあし	人足
ひとあせ	一汗
ひとあめ	一雨
ひどう	非道
びとう	尾燈
ひとがき	人垣
ひとかげ	人影
ひとかず	人数
ひとがら	人柄
ひとく	秘匿
びとく	美徳
ひとくせ	一癖
ひとけ	人気
ひとごえ	人声
ひとこと	一言
ひとざと	人里
ひとしお	一塩
ひとじち	人質
ひとだま	人魂
ひとづま	人妻
ひとて	一手
ひとで	人手
ひとで	人出
ひととき	一時
ひとなか	人中
ひとなみ	人波
ひとばしら	人柱
ひとはだ	一肌
ひとひ	一日
ひとびと	人々
ひとふで	一筆
ひとまえ	人前
ひとむかし	一昔
ひとめ	一目
ひとめ	人目
ひとやま	人山
ひな	ひな
ひなか	日中
ひなが	日永
ひなん	批難
ひなん	避難
ひなん	非難
びなん	美男
ひにく	皮肉
ひにん	否認
ひにん	避妊
ひにん	非人
びねつ	微熱
ひばし	火箸
ひばち	火鉢
ひばな	火花
ひはん	批判
ひばん	非番
ひひ	ひひ
ひひ	霏々
ひび	ひび
ひび	日々
びび	微々
ひびき	響き
ひびく	響く
ひひょう	批評
びひん	備品
ひふ	皮膚
ひぶ	日歩
びふう	微風
びふう	美風
ひふく	被服
ひふく	被覆
ひふん	悲憤
ひぶん	碑文
びぶん	微分
びぶん	美文
ひへい	疲弊
ひほう	悲報
ひほう	秘法
ひぼう	誹謗
ひぼう	非望
びぼう	備忘
びぼう	美貌
ひぼん	非凡
ひま	ひま
ひまく	皮膜
ひまご	曾孫
ひまん	肥満
びみ	美味
ひみつ	秘密
びみょう	微妙
ひめい	悲鳴
びめい	美名
ひめん	罷免
ひも	ひも
ひもく	費目
ひもと	火元
ひもの	干物
ひやあせ	冷汗
ひやく	飛躍
びゃくい	白衣
びゃくえ	白衣
ひゃくしょう	百姓
ひゃくせん	百千
ひゃくまん	百万
ひゃっか	百貨
ひやむぎ	冷麦
ひやめし	冷飯
ひゆ	譬喩
びゅうけん	謬見
ひよう	費用
ひよう	飛揚
びよう	美容
ひょういつ	飄逸
びょういん	病院
ひょうか	評価
ひょうが	氷河
びょうが	病臥
ひょうかい	氷解
ひょうかい	氷塊
びょうがい	病害
ひょうき	標記
ひょうき	表記
ひょうぎ	評議
びょうき	病気
ひょうきん	剽軽
びょうきん	病菌
びょうく	病躯
ひょうけつ	氷結
ひょうけつ	表決
ひょうけつ	評決
ひょうげん	氷原
ひょうげん	表現
びょうげん	病原
ひょうご	標語
ひょうご	評語
びょうご	病後
ひょうこう	標高
ひょうさつ	標札
ひょうざん	氷山
ひょうし	拍子
ひょうし	表紙
ひょうじ	表示
びょうし	病死
ひょうしき	標識
びょうしつ	病室
びょうしゃ	描写
ひょうしゃく	評釈
びょうじゃく	病弱
ひょうしゅつ	表出
ひょうじゅん	標準
ひょうしょう	表彰
ひょうしょう	表象
ひょうじょう	表情
ひょうじょう	評定
びょうしょう	病床
びょうじょう	病状
びょうしん	病身
びょうしん	秒針
びょうせい	病勢
ひょうせつ	剽窃
ひょうぜん	飄然
びょうそく	秒速
ひょうだい	標題
びょうたい	病体
ひょうちゃく	漂着
ひょうちゅう	標注
ひょうちゅう	氷柱
ひょうちゅう	評注
びょうちゅう	病中
ひょうてい	評定
ひょうてき	標的
びょうてき	病的
ひょうてん	氷点
ひょうてん	評点
ひょうでん	評伝
びょうどう	平等
びょうどく	病毒
びょうにん	病人
ひょうのう	氷嚢
ひょうはく	漂白
ひょうばん	評判
ひょうひ	表皮
ひょうひょう	飄々
びょうぶ	屏風
ひょうほう	兵法
ひょうぼう	標榜
びょうぼう	渺茫
びょうぼつ	病没
ひょうほん	標本
びょうま	病魔
ひょうめい	表明
びょうめい	病名
ひょうめん	表面
ひょうり	表裏
びょうり	病理
ひょうりゅう	漂流
ひょうろう	漂浪
ひょうろう	兵糧
ひょうろん	評論
ひよく	肥沃
ひより	日和
びら	びら
ひらい	飛来
ひらき	開き
ひらく	開く
ひらて	平手
ひらや	平屋
びり	びり
ひりき	非力
ひりつ	比率
ひりょう	肥料
びりょう	微量
びりょく	微力
ひる	ひる
ひる	干る
びる	ビル
ひるい	比類
ひるどき	昼時
ひるなか	昼中
ひるね	昼寝
ひるま	昼間
ひるめし	昼飯
ひれ	ひれ
ひれい	比例
ひれい	非礼
びれい	美麗
ひれつ	卑劣
ひろい	広い
ひろい	拾い
ひろう	拾う
ひろう	披露
ひろう	疲労
びろう	尾篭
ひろさ	広さ
ひろば	広場
ひろびろ	広々
ひろま	広間
ひろめ	広め
ひわ	悲話
ひわ	秘話
びわ	びわ
びわ	琵琶
ひわい	卑猥
ひわり	日割
びん	びん
ぴん	ピン
ひんい	品位
ひんかく	品格
ひんかく	賓客
びんかつ	敏活
びんかん	敏感
びんぎ	便宜
ひんきゃく	賓客
ひんきゅう	貧窮
ひんく	貧苦
ひんけつ	貧血
ひんこう	品行
ひんこん	貧困
ひんし	品詞
ひんし	瀕死
ひんしつ	品質
ひんじゃ	貧者
ひんじゃく	貧弱
ひんしゅ	品種
びんしょう	敏捷
びんじょう	便乗
ひんせい	品性
びんせん	便船
びんせん	便箋
ひんそう	貧相
びんそく	敏速
ひんど	頻度
ひんとう	品等
ひんのう	貧農
ひんぱん	頻繁
ひんぴょう	品評
ひんぴん	頻々
ひんぷ	貧富
ひんぷん	繽紛
びんぼう	貧乏
ひんみん	貧民
ひんめい	品名
ひんもく	品目
びんらん	便覧
びんらん	紊乱
びんわん	敏腕
ぶあい	歩合
ふあん	不安
ふい	ふい
ふい	不意
ぶい	ブイ
ふいちょう	吹聴
ふいつ	不乙
ぶいん	部員
ふうい	風位
ふういん	封印
ふうう	風雨
ふううん	風雲
ふうか	風化
ふうが	風雅
ふうがい	風害
ふうかく	風格
ふうき	富貴
ふうき	風紀
ふうぎ	風儀
ふうきょう	風教
ふうけい	風景
ふうこう	風光
ふうさ	封鎖
ふうさい	風采
ふうさつ	封殺
ふうし	風刺
ふうし	風姿
ふうじ	封じ
ふうしゃ	風車
ふうじゃ	風邪
ふうしゅう	風習
ふうしょ	封書
ふうせつ	風説
ふうせつ	風雪
ふうせん	風船
ふうそく	風速
ふうぞく	風俗
ふうたい	風袋
ふうち	風致
ふうちょう	風潮
ふうてい	風体
ふうてん	瘋癲
ふうど	風土
ふうとう	封筒
ふうにゅう	封入
ふうは	風波
ふうばい	風媒
ふうび	風靡
ふうひょう	風評
ふうふ	夫婦
ふうぶつ	風物
ふうぶん	風聞
ふうぼう	風貌
ふうみ	風味
ふうりゅう	風流
ふうりょく	風力
ふうりん	風鈴
ふうろう	風浪
ふうん	不運
ぶうん	武運
ふえき	不易
ふえん	不縁
ふえん	敷衍
ぶおとこ	醜男
ふおん	不穏
ふか	ふか
ふか	不可
ふか	付加
ふか	賦課
ふか	孵化
ぶか	部下
ふかい	深い
ふかい	不快
ぶがい	部外
ふかく	不覚
ふかで	深手
ふかぶか	深々
ふかみ	深み
ふかみどり	深緑
ふかん	俯瞰
ぶかん	武官
ふき	ふき
ふき	付記
ふぎ	不義
ふぎ	付議
ぶき	武器
ふきつ	不吉
ふきゅう	不急
ふきゅう	不朽
ふきゅう	普及
ふきゅう	腐朽
ふきょう	不況
ふきょう	不興
ふきょう	富強
ふきょう	布教
ぶぎょう	奉行
ぶきょく	部局
ふきん	付近
ふきん	布巾
ふく	拭く
ふく	吹く
ふく	葺く
ふぐ	不具
ふくあん	腹案
ふくいく	馥郁
ふくいん	復員
ふくいん	幅員
ふくいん	福音
ふぐう	不遇
ふくえき	服役
ふくえん	復縁
ふくかん	副官
ふくがん	複眼
ふくぎょう	副業
ふくきん	復金
ふくげん	復元
ふくげん	復原
ふくごう	複合
ふくさ	袱紗
ふくざい	服罪
ふくざつ	複雑
ふくし	副詞
ふくし	福祉
ふくじ	服地
ふくしき	複式
ふくしゃ	複写
ふくしゃ	輻射
ふくしゅう	復習
ふくしゅう	復讎
ふくじゅう	服従
ふくしょう	副将
ふくしょう	復唱
ふくしょく	復職
ふくしょく	服飾
ふくしん	腹心
ふくすう	複数
ふくせい	複製
ふくせき	復籍
ふくせん	伏線
ふくせん	複線
ふくそう	服装
ふくそう	輻輳
ふくぞう	腹蔵
ふくちょう	復調
ふくつ	不屈
ふくつう	腹痛
ふくどく	服毒
ふくはい	復配
ふくはい	腹背
ふくびき	福引
ふくぶ	腹部
ふくぶん	複文
ふくへい	伏兵
ふくみ	含み
ふくむ	含む
ふくむ	服務
ふくめい	復命
ふくめん	覆面
ふくも	服喪
ふくやく	服薬
ふくよう	服用
ふくよう	複葉
ふくり	福利
ふくり	複利
ふくろ	復路
ふくろぬの	袋布
ふくん	夫君
ぶくん	武勲
ふけ	ふけ
ぶけ	武家
ふけい	不敬
ふけい	父兄
ふけい	父系
ぶげい	武芸
ふけつ	不潔
ふけん	府県
ふけん	父権
ふげん	不言
ふげん	付言
ふこう	不孝
ふこう	不幸
ふごう	富豪
ふごう	符号
ふごう	符合
ふこく	布告
ぶこつ	無骨
ふざ	趺坐
ふさい	夫妻
ふさい	負債
ふざい	不在
ふさく	不作
ぶざま	無様
ふさん	不参
ふし	ふし
ふし	父子
ふじ	ふじ
ふじ	不時
ぶし	武士
ぶじ	無事
ふしあな	節穴
ふじだな	藤棚
ふしめ	伏目
ふしゅ	浮腫
ぶしゅ	部首
ぶじゅつ	武術
ふじゅん	不純
ふじゅん	不順
ふじょ	婦女
ふじょ	扶助
ぶしょ	部署
ふしょう	不祥
ふしょう	不肖
ふしょう	不詳
ふしょう	負傷
ふじょう	不浄
ふじょう	不定
ぶしょう	不精
ぶしょう	無精
ふしょく	腐蝕
ぶじょく	侮辱
ふしん	不信
ふしん	不審
ふしん	不振
ふしん	普請
ふじん	夫人
ふじん	婦人
ふじん	布陣
ぶしん	武神
ふす	伏す
ふず	付図
ふずい	付随
ふすう	負数
ぶすう	部数
ふせ	布施
ふせい	不正
ふぜい	風情
ぶぜい	無勢
ふせぎ	防ぎ
ふせぐ	防ぐ
ふせつ	敷設
ふせつ	符節
ふせん	付箋
ふそ	父祖
ぶそう	武装
ふそく	不足
ふそく	付則
ふぞく	付属
ぶぞく	部族
ふそん	不遜
ふた	ふた
ぶた	ぶた
ふたい	付帯
ぶたい	舞台
ぶたい	部隊
ふたえ	二重
ふたおや	二親
ふたく	付託
ふたごころ	二心
ふたこと	二言
ふたたび	再び
ふたば	双葉
ふたん	負担
ぶだん	武断
ふち	ふち
ふち	扶持
ぶち	ぶち
ふちゃく	付着
ふちょう	不調
ふちょう	符牒
ぶちょう	部長
ふちん	浮沈
ぶつ	ぶつ
ふつう	不通
ふつう	普通
ぶっか	物価
ぶっかく	仏閣
ふっかつ	復活
ふっかん	副官
ふっき	富貴
ふっき	復帰
ぶつぎ	物議
ふっきゅう	復仇
ふっきゅう	復旧
ふつぎょう	払暁
ぶっきょう	仏教
ふつぐん	仏軍
ぶっけん	物件
ふっこ	復古
ぶっこ	物故
ふっこう	復興
ぶっさん	物産
ぶっし	物資
ぶつじ	仏事
ぶつじ	仏寺
ふっしき	払拭
ぶっしき	仏式
ぶっしつ	物質
ふっしょく	払拭
ぶっしょく	物色
ぶっしん	物心
ぶっそう	物騒
ぶつぞう	仏像
ぶったい	物体
ぶつだん	仏壇
ふってい	払底
ふってん	沸点
ぶってん	仏典
ふっとう	沸騰
ぶつどう	仏道
ぶつのう	物納
ぶつぴん	物品
ふつほう	仏法
ぶっぽう	仏法
ぶつよく	物欲
ぶつり	物理
ぶつりょう	物量
ふてい	不貞
ふてい	不定
ふてい	不逞
ふでがしら	筆頭
ふてき	不敵
ふでぐせ	筆癖
ふでさき	筆先
ふでばこ	筆箱
ふでぶと	筆太
ふと	ふと
ぶと	ぶと
ふとい	太い
ふとう	不当
ふとう	不等
ふとう	埠頭
ふどう	不動
ふどう	不同
ふどう	浮動
ぶとう	舞踏
ぶどう	武道
ふとく	不徳
ふところで	懐手
ふとめ	太目
ふとる	太る
ふとん	蒲団
ふな	ふな
ふなあし	船足
ふなうた	船歌
ふなおさ	艦長
ふなか	不仲
ふなじ	船路
ふなぞこ	船底
ふなたび	船旅
ふなちん	船賃
ふなで	船出
ふなぬし	船主
ふなばし	船橋
ふなびん	船便
ふなよい	船酔
ぶなん	無難
ふにん	赴任
ふねん	不燃
ふのう	不能
ふはい	不敗
ふはい	腐敗
ふばい	不買
ふはく	浮薄
ふはつ	不発
ふび	不備
ぶび	武備
ふひょう	不評
ふひょう	浮標
ふひょう	浮氷
ふびん	不憫
ぶひん	部品
ふぶき	吹雪
ふふく	不服
ぶぶん	部分
ふへい	不平
ぶべつ	侮蔑
ふへん	不偏
ふへん	不変
ふへん	普遍
ふべん	不便
ふぼ	父母
ふほう	不法
ふほう	訃報
ふまん	不満
ふみ	ふみ
ふみん	不眠
ふむ	踏む
ふめい	不明
ぶめい	武名
ふめつ	不滅
ぶめん	部面
ふもう	不毛
ふもん	不問
ぶもん	武門
ぶもん	部門
ふゆう	富裕
ふゆう	浮遊
ぶゆう	武勇
ふゆぞら	冬空
ふゆば	冬場
ふゆもの	冬物
ふゆやま	冬山
ふよ	付与
ふよ	賦与
ぶよ	ぶよ
ふよう	不用
ふよう	不要
ふよう	扶養
ふよう	浮揚
ぶよう	舞踊
ぶらい	無頼
ぶらく	部落
ふらち	不埓
ふらん	腐爛
ふり	ふり
ふり	降り
ふり	振り
ふり	不利
ぶり	ぶり
ふりかえ	振替
ふりそで	振袖
ふりゅう	浮流
ふりょ	不慮
ふりょ	俘虜
ふりょう	不漁
ふりょう	不良
ぶりょう	無聊
ふりょく	浮力
ぶりょく	武力
ふる	フル
ふる	降る
ふる	振る
ぶる	ぶる
ふるい	古い
ぶるい	部類
ふるいけ	古池
ふるう	奮う
ふるう	篩う
ふるがお	古顔
ふるかぶ	古株
ふるぎ	古着
ふるす	古巣
ふるて	古手
ふるほん	古本
ふるまい	振舞
ふるもの	古物
ふれ	ふれ
ぶれい	無礼
ふろ	風呂
ぷろ	プロ
ふろう	浮浪
ふろく	付録
ふわ	不和
ふん	ふん
ぶんあん	文案
ぶんい	文意
ふんえん	噴煙
ふんか	噴火
ぶんか	分化
ぶんか	分科
ぶんか	文化
ぶんか	文科
ふんがい	憤慨
ぶんかい	分会
ぶんかい	分解
ぶんがく	文学
ぶんかつ	分割
ぶんかん	文官
ふんき	奮起
ふんぎ	紛議
ぶんき	分岐
ふんきゅう	紛糾
ぶんきょう	文教
ぶんぎょう	分業
ぶんぐ	文具
ぶんけ	分家
ぶんげい	文芸
ふんげき	憤激
ぶんけつ	分蘖
ぶんけん	分権
ぶんけん	文献
ぶんげん	分限
ぶんこ	文庫
ぶんご	文語
ぶんこう	分校
ぶんごう	文豪
ふんさい	粉砕
ふんざい	粉剤
ぶんさい	文才
ぶんざい	分際
ぶんさん	分散
ふんし	憤死
ぶんし	分子
ぶんし	文士
ふんしつ	紛失
ふんしゃ	噴射
ぶんじゃく	文弱
ぶんしゅう	文集
ふんしゅつ	噴出
ぶんしょ	文書
ふんじょう	紛擾
ぶんしょう	分掌
ぶんしょう	文章
ぶんしょう	文相
ぶんじょう	分譲
ふんしょく	粉飾
ふんしょく	粉食
ぶんしょく	文飾
ぶんじん	文人
ふんすい	噴水
ぶんすう	分数
ぶんせき	分析
ぶんせき	文責
ふんせん	噴泉
ふんせん	奮戦
ふんぜん	憤然
ふんぜん	奮然
ぶんせん	文選
ふんそう	扮装
ふんそう	紛争
ぶんたい	分隊
ぶんたい	文体
ぶんだい	文題
ふんたん	粉炭
ぶんたん	分担
ぶんだん	文壇
ぶんちん	文鎮
ぶんつう	文通
ぶんてん	分店
ぶんてん	文典
ふんど	憤怒
ふんとう	奮闘
ふんどう	分銅
ふんにゅう	粉乳
ふんにょう	糞尿
ぶんぱ	分派
ぶんばい	分売
ぶんぱい	分配
ふんぱつ	奮発
ぶんぴつ	分泌
ぶんぴつ	文筆
ぶんぶ	文武
ぶんぷ	分布
ぶんぶつ	文物
ふんぷん	紛々
ふんぷん	紛紛
ふんべつ	分別
ふんべん	糞便
ぶんべん	分娩
ふんぼ	墳墓
ぶんぼ	分母
ぶんぽう	文法
ふんぽん	粉本
ふんまつ	粉末
ふんまん	憤懣
ぶんみゃく	文脈
ぶんめ	分目
ぶんめい	文明
ぶんめん	文面
ぶんや	分野
ぶんらん	紊乱
ぶんり	分離
ぶんりつ	分立
ふんりゅう	噴流
ぶんりょう	分量
ぶんるい	分類
ふんれい	奮励
ぶんれい	文例
ぶんれつ	分列
ぶんれつ	分裂
へい	へい
へいあん	平安
へいい	平易
へいえい	兵営
へいえき	兵役
べいえん	米塩
へいおん	平温
へいおん	平穏
へいか	平価
へいか	陛下
べいか	米価
へいかい	閉会
へいがい	弊害
へいかつ	平滑
へいき	兵器
へいき	平気
へいきん	平均
べいぐん	米軍
へいけ	平家
へいげい	睥睨
へいけつ	併結
へいげん	平原
へいこう	平行
へいこう	平衡
へいこう	並行
へいこう	閉口
へいごう	併合
べいこく	米国
べいこく	米穀
へいさ	閉鎖
べいさく	米作
へいさつ	併殺
へいし	兵士
へいし	閉止
へいじ	兵事
へいじ	平時
へいじつ	平日
へいしゃ	兵舎
べいじゅ	米寿
へいじょう	平常
べいしょく	米食
べいじん	米人
へいせい	兵制
へいせい	平静
へいぜい	平生
へいぜん	平然
へいそ	平素
へいそく	閉塞
へいそつ	兵卒
へいそん	並存
へいぞん	並存
へいたい	兵隊
へいたん	平坦
へいだん	兵団
へいち	平地
へいてい	平定
へいてい	閉廷
へいてん	閉店
へいねつ	平熱
へいねん	平年
へいば	兵馬
へいはつ	併発
へいばん	平板
へいふう	弊風
へいふく	平伏
へいふく	平服
へいへん	兵変
へいほう	兵法
へいほう	平方
へいぼん	平凡
へいみん	平民
へいめい	平明
へいめん	平面
へいや	平野
へいゆ	平癒
へいよう	併用
へいらん	兵乱
へいりつ	並立
へいりょく	兵力
へいれつ	併列
へいれつ	並列
へいわ	平和
へえ	へえ
へきえき	辟易
へきが	壁画
へきち	僻地
へきとう	劈頭
ぺけ	ぺけ
へそ	へそ
べそ	べそ
へた	下手
へだて	隔て
べっかく	別格
べっかん	別館
べっきょ	別居
べっけん	瞥見
べっこ	別個
べっこう	別項
べっこう	鼈甲
べっさつ	別冊
べっし	別紙
べっし	蔑視
べっしつ	別室
べっしゅ	別種
べつじょう	別状
べつじん	別人
べっそう	別荘
べつだん	別段
べってい	別邸
べっと	別途
べっとう	別当
べつぬの	別布
べっぱ	別派
べっぴょう	別表
べっぴん	別嬪
べつべつ	別々
べつり	別離
へど	反吐
べにいろ	紅色
へび	へび
へへ	ヘヘ
へぼ	へぼ
へま	へま
へや	へや
へら	へら
へり	へり
へる	へる
へる	経る
へる	減る
べる	ベル
へん	へん
ぺん	ペン
へんあい	偏愛
へんあつ	変圧
へんい	変異
へんい	変移
へんえい	片影
べんえき	便益
へんか	変化
べんかい	弁解
へんかく	変格
へんかく	変革
べんがく	勉学
へんかん	変換
へんかん	返還
べんき	便器
べんぎ	便宜
へんきゃく	返却
へんきょう	偏狭
へんきょう	辺境
べんきょう	勉強
へんきょく	編曲
へんきん	返金
へんくつ	偏屈
へんげ	変化
へんけい	変形
べんけい	弁慶
へんけん	偏見
べんご	弁護
へんこう	偏向
へんこう	変更
へんさ	偏差
へんさい	返済
へんざい	偏在
へんざい	遍在
べんさい	弁才
べんさい	弁済
へんさん	編纂
へんし	変死
へんじ	変事
へんじ	返事
べんし	弁士
へんしつ	変質
へんしゃ	編者
へんしゅ	変種
へんしゅう	編修
へんしゅう	編集
へんしょ	返書
べんじょ	便所
へんじょう	返上
べんしょう	弁償
へんしょく	偏食
へんしょく	変色
へんしん	変心
へんしん	返信
へんじん	変人
へんすう	変数
へんせい	変性
へんせい	編成
へんせつ	変節
べんぜつ	弁舌
へんせん	変遷
へんそう	変装
へんそう	返送
へんぞう	変造
へんそく	変則
へんたい	変態
へんたい	編隊
べんたつ	鞭撻
へんち	辺地
へんちょ	編著
へんちょう	偏重
へんちょう	変調
べんつう	便通
へんてつ	変哲
へんてん	変転
へんでん	返電
へんとう	返答
へんどう	変動
べんとう	弁当
へんにゅう	編入
へんのう	返納
へんぱ	偏頗
へんぴ	辺鄙
べんぴ	便秘
へんぴん	返品
へんぺい	扁平
べんべつ	弁別
へんぺん	片々
へんぼう	偏旁
へんぼう	変貌
へんぽう	返報
べんぽう	便法
へんぽん	翩翻
へんめい	変名
べんめい	弁明
べんらん	便覧
べんり	便利
へんりん	片鱗
へんれい	返礼
べんれい	勉励
へんれき	遍歴
へんろ	遍路
べんろん	弁論
ほあん	保安
ほい	ほい
ほい	補遺
ほい	本意
ぽい	ぽい
ほいく	保育
ぼいん	母音
ほう	ほう
ほうあん	法案
ほうい	包囲
ほうい	方位
ほうい	法衣
ぼうい	暴威
ほういつ	放逸
ぼういん	暴飲
ほうえ	法衣
ほうえ	法会
ぼうえい	防衛
ぼうえき	貿易
ぼうえき	防疫
ほうえつ	法悦
ぼうえん	望遠
ほうおう	法王
ほうおん	報恩
ぼうおん	忘恩
ぼうおん	防音
ほうか	放火
ほうか	放課
ほうか	法科
ほうか	砲火
ほうか	邦家
ほうが	萌芽
ぼうか	防火
ほうかい	崩壊
ほうがい	法外
ぼうがい	妨害
ぼうがい	望外
ほうがく	方角
ほうがく	法学
ほうがく	邦楽
ほうかつ	包括
ほうがん	包含
ほうがん	砲丸
ぼうかん	傍観
ぼうかん	防寒
ほうき	放棄
ほうき	法規
ほうき	芳紀
ほうき	蜂起
ぼうぎ	謀議
ぼうきゃく	忘却
ぼうぎゃく	暴虐
ほうきゅう	俸給
ほうぎょ	崩御
ぼうきょ	暴挙
ぼうぎょ	防禦
ぼうきょう	望郷
ぼうきょう	防共
ほうぎょく	宝玉
ほうぐ	反故
ぼうぐい	棒杭
ぼうくう	防空
ぼうくん	暴君
ほうけい	方形
ぼうけい	傍系
ぼうけい	謀計
ほうげき	砲撃
ほうけん	封建
ほうげん	放言
ほうげん	方言
ぼうけん	冒険
ぼうげん	暴言
ほうこ	宝庫
ほうご	反故
ぼうご	防護
ほうこう	奉公
ほうこう	放校
ほうこう	方向
ほうこう	芳香
ほうこう	咆哮
ほうこう	彷徨
ほうごう	縫合
ぼうこう	暴行
ぼうこう	膀胱
ほうこく	報告
ほうこく	報国
ぼうこく	亡国
ほうさく	方策
ほうさく	豊作
ぼうさつ	忙殺
ほうさん	放散
ほうさん	硼酸
ほうし	奉仕
ほうし	放恣
ほうし	法師
ほうし	胞子
ほうし	芳志
ほうじ	法事
ぼうし	帽子
ぼうし	防止
ほうしき	方式
ほうしき	法式
ぼうしつ	亡失
ほうしゃ	放射
ぼうしゃ	防砂
ぼうじゅ	傍受
ほうしゅう	報酬
ほうじゅう	放縦
ぼうしゅう	防臭
ほうしゅく	奉祝
ほうしゅつ	放出
ほうじゅん	芳醇
ほうしょ	奉書
ほうじょ	幇助
ぼうじょ	防除
ほうしょう	報償
ほうしょう	報奨
ほうしょう	放縦
ほうしょう	褒章
ほうじょう	方丈
ほうじょう	法帖
ほうじょう	豊饒
ぼうしょう	傍証
ぼうしょう	帽章
ほうしょく	奉職
ぼうしょく	暴食
ほうしん	放心
ほうしん	方針
ほうじん	法人
ほうじん	邦人
ぼうず	坊主
ほうすい	放水
ぼうすい	防水
ほうせい	法制
ほうせい	法政
ほうせい	砲声
ぼうせい	暴政
ほうせき	宝石
ぼうせき	紡績
ぼうせん	傍線
ぼうせん	棒線
ぼうせん	防戦
ぼうぜん	茫然
ほうそう	包装
ほうそう	放送
ほうそう	疱瘡
ほうぞう	包蔵
ぼうそう	暴走
ほうそく	法則
ほうたい	繃帯
ほうだい	砲台
ぼうだい	尨大
ほうだん	放談
ほうだん	法談
ほうだん	砲弾
ほうち	報知
ほうち	放置
ほうち	法治
ほうちく	放逐
ぼうちゅう	傍注
ほうちょう	庖丁
ぼうちょう	傍聴
ぼうちょう	防諜
ぼうちよう	膨脹
ほうてい	捧呈
ほうてい	法定
ほうてい	法廷
ほうてき	放擲
ほうてん	宝典
ほうてん	法典
ほうでん	放電
ぼうてん	傍点
ほうと	方途
ぼうと	暴徒
ほうとう	放蕩
ほうどう	報道
ぼうとう	暴騰
ぼうとう	冒頭
ぼうどう	暴動
ほうとく	報徳
ほうどく	奉読
ぼうどく	防毒
ほうにち	訪日
ほうにょう	放尿
ほうにん	放任
ほうねつ	放熱
ほうねん	放念
ほうねん	豊年
ほうのう	奉納
ぼうは	防波
ほうはい	澎湃
ほうばい	朋輩
ぼうばく	茫漠
ぼうはつ	暴発
ぼうはん	防犯
ほうひ	放屁
ほうび	褒美
ぼうび	防備
ほうふ	抱負
ほうふ	豊富
ぼうふ	亡夫
ぼうふ	亡父
ぼうふ	防腐
ぼうふう	暴風
ぼうふう	防風
ほうふく	報復
ほうふく	法服
ほうふつ	髣髴
ほうぶん	法文
ほうへい	砲兵
ぼうへき	防壁
ほうべん	方便
ぼうぼ	亡母
ほうほう	方法
ほうぼう	方々
ほうぼく	放牧
ほうまん	豊満
ぼうまん	暴慢
ほうみょう	法名
ほうむ	法務
ほうむる	葬る
ほうめい	芳名
ぼうめい	亡命
ほうめん	放免
ほうめん	方面
ほうもう	法網
ほうもつ	宝物
ほうもん	訪問
ぼうや	坊や
ほうよう	包容
ほうよう	抱擁
ほうよう	法要
ぼうよう	茫洋
ほうよく	豊沃
ほうよく	鵬翼
ほうらく	崩落
ぼうらく	暴落
ぼうり	暴利
ほうりつ	法律
ぼうりゃく	謀略
ほうりゅう	放流
ほうりょう	豊漁
ぼうりょく	暴力
ほうるい	堡塁
ほうれい	法令
ぼうれい	亡霊
ぼうれい	暴戻
ほうろう	放浪
ぼうろう	望楼
ぼうろん	暴論
ほうわ	法話
ほうわ	飽和
ぼお	ボー
ほおづえ	頬杖
ほおべに	頬紅
ほおぼね	頬骨
ほおん	保温
ほか	ほか
ほかく	捕獲
ほかげ	火影
ほかん	保管
ぼかん	母艦
ぼき	簿記
ほきゅう	補給
ほきょう	補強
ぼきん	募金
ほぐ	反故
ほくい	北緯
ほくおう	北欧
ほくげん	北限
ぼくさつ	撲殺
ぼくし	牧師
ぼくしゃ	牧舎
ぼくしゅ	墨守
ぼくじゅう	墨汁
ほくじょう	北上
ぼくじょう	牧場
ぼくせき	木石
ぼくそう	牧草
ぼくちく	牧畜
ほくとう	北東
ぼくとう	木刀
ぼくどう	牧童
ぼくとつ	朴訥
ほくぶ	北部
ほくべい	北米
ぼくめつ	撲滅
ほくよう	北洋
ほくりく	北陸
ぼけ	ぼけ
ほげい	捕鯨
ぼけい	母型
ぼけい	母系
ほけつ	補欠
ぼけつ	墓穴
ほけん	保健
ほけん	保険
ほご	反故
ほご	保護
ほこう	歩行
ぼこう	母校
ぼこく	母国
ほこり	誇り
ほさ	輔佐
ほさき	穂先
ぼさつ	菩薩
ぼさん	墓参
ほし	干し
ほじ	保持
ぼし	母子
ほしがき	干柿
ほしじるし	星印
ほしぞら	星空
ほしゃく	保釈
ほしゅ	保守
ほしゅ	捕手
ほしゅう	補修
ほしゅう	補習
ほじゅう	補充
ぼしゅう	募集
ほじょ	補助
ぼしょ	墓所
ほしょう	保証
ほしょう	保障
ほしょう	歩哨
ほしょう	補償
ぼじょう	慕情
ほしょく	補職
ほしん	保身
ぼしん	戊申
ほす	干す
ぼす	ボス
ほせい	補整
ほせい	補正
ぼせい	母性
ぼせき	墓石
ほせつ	補説
ほぜん	保全
ぼせん	母船
ぼぜん	墓前
ほぞ	ほぞ
ほそい	細い
ほそう	舗装
ほそうで	細腕
ほそく	捕捉
ほそく	歩測
ほそく	補足
ほそじ	細字
ほそびき	細引
ほそぼそ	細々
ほそめ	細目
ほそる	細る
ほぞん	保存
ぼたい	母体
ぼだい	菩提
ぼち	墓地
ほちょう	歩調
ぼっか	牧歌
ぼつが	没我
ほっき	発起
ほつぎ	発議
ぼっき	勃起
ぼっきゃく	没却
ほっきょく	北極
ぼつご	没後
ぼっこう	勃興
ほっこく	北国
ほっさ	発作
ぼっしゅう	没収
ぼっしょ	没書
ほっしん	発心
ほっしん	発疹
ほっす	法主
ぼつぜん	勃然
ほっそく	発足
ほったん	発端
ぼっとう	没頭
ぼつにゅう	没入
ぼつねん	没年
ぼっぱつ	勃発
ほっぽう	北方
ぼつらく	没落
ほてい	布袋
ほてん	補填
ほど	ほど
ほどう	舗道
ほどう	歩道
ほどう	補導
ぼどう	母堂
ほどこし	施し
ほどこす	施す
ほどほど	程々
ほにゅう	哺乳
ぼにゅう	母乳
ほねみ	骨身
ほばく	捕縛
ほばしら	帆柱
ぼひ	墓碑
ぼひょう	墓標
ほふく	匍匐
ほぶね	帆船
ほふる	屠る
ほへい	歩兵
ぼへい	募兵
ほぼ	ほぼ
ほぼ	保母
ほまれ	誉れ
ぼや	ぼや
ぼや	暮夜
ほゆう	保有
ほよう	保養
ほら	ほら
ほら	法螺
ほらあな	洞穴
ほり	彫り
ほりばた	堀端
ほりゅう	保留
ほりょ	捕虜
ほる	掘る
ほる	彫る
ぼる	ぼる
ほろ	ほろ
ぼろ	ぼろ
ほろう	歩廊
ほろぶ	亡ぶ
ほん	ホン
ぽん	ぽん
ほんあん	翻案
ほんい	本位
ほんい	本意
ほんいん	本因
ほんえい	本営
ほんか	本科
ほんかい	本懐
ほんかく	本格
ほんかん	本官
ほんかん	本館
ほんがん	本願
ほんき	本気
ほんきょ	本拠
ほんぎょう	本業
ほんけ	本家
ほんけん	本件
ほんこう	本校
ほんごく	本国
ほんごし	本腰
ほんさい	本妻
ぼんさい	盆栽
ほんざん	本山
ほんし	本誌
ほんしき	本式
ほんしつ	本質
ほんじつ	本日
ほんしゃ	本社
ぼんしゅ	凡手
ほんしゅう	本州
ほんしょ	本書
ほんしょう	本性
ほんしょく	本職
ほんしん	本心
ほんじん	本陣
ぼんじん	凡人
ほんず	本図
ほんすじ	本筋
ほんせい	本性
ほんせき	本籍
ほんせん	本線
ほんせん	本船
ほんぜん	本然
ほんぜん	翻然
ほんそう	奔走
ほんぞう	本草
ぼんぞく	凡俗
ほんぞん	本尊
ほんたい	本体
ほんだい	本代
ほんだい	本題
ほんだな	本棚
ぼんち	盆地
ほんてん	本店
ほんでん	本殿
ほんど	本土
ほんとう	奔騰
ほんとう	本島
ほんとう	本当
ほんどう	本堂
ほんどう	本道
ほんにん	本人
ほんね	本音
ほんねん	本然
ほんねん	本年
ほんのう	本能
ぼんのう	煩悩
ほんば	奔馬
ほんば	本場
ほんばこ	本箱
ほんぶ	本部
ほんぶん	本分
ほんぶん	本文
ほんぽう	奔放
ほんぽう	本法
ほんぽう	本邦
ほんまつ	本末
ほんまる	本丸
ほんみょう	本名
ほんむ	本務
ほんめい	奔命
ほんもう	本望
ほんもと	本元
ほんもの	本物
ほんもん	本文
ほんや	本屋
ほんやく	翻訳
ぼんよう	凡庸
ほんらい	本来
ほんりゅう	奔流
ほんりゅう	本流
ほんりょう	本領
ほんるい	本塁
ほんれき	本暦
ほんろう	翻弄
ほんろん	本論
まあ	まあ
まいあさ	毎朝
まいかい	毎回
まいきょ	枚挙
まいげつ	毎月
まいしゅう	毎週
まいしん	邁進
まいせつ	埋設
まいそう	埋葬
まいぞう	埋蔵
まいだん	毎段
まいつき	毎月
まいど	毎度
まいとし	毎年
まいなつ	毎夏
まいにち	毎日
まいねん	毎年
まいばん	毎晩
まいひめ	舞姫
まいぼつ	埋没
まいまい	毎々
まいよ	毎夜
まいり	参り
まいる	参る
まう	舞う
まうえ	真上
まえあし	前足
まえかけ	前掛
まえがしら	前頭
まえがみ	前髪
まえきん	前金
まえすそ	前裾
まえそで	前袖
まえば	前歯
まえはし	前端
まえはば	前幅
まえび	前日
まえまえ	前々
まえわき	前脇
まおう	魔王
まがい	紛い
まがお	真顔
まかず	間数
まき	巻き
まきえ	蒔絵
まきがい	巻貝
まきじた	巻舌
まきた	真北
まきば	牧場
まきもの	巻物
まぎれ	紛れ
まぎわ	間際
まく	巻く
まく	撒く
まく	蒔く
まくうち	幕内
まくした	幕下
まぐそ	馬糞
まぐち	間口
まくらことば	枕詞
まけ	負け
まげ	まげ
まげ	曲げ
まご	馬子
まごころ	真心
まさき	柾木
まさつ	摩擦
まさめ	柾目
まさゆめ	正夢
まさり	勝り
まし	増し
ました	真下
ましゅ	魔手
まじゅつ	魔術
まじょ	魔女
ましろ	真白
ます	ます
ます	マス
ます	増す
まず	まず
ますい	麻酔
まそん	磨損
また	また
まだ	まだ
またがみ	股上
またした	股下
またたび	股旅
まち	まち
まち	待ち
まちあい	待合
まぢか	真近
まちかど	町角
まちぎ	街着
まつ	まつ
まつ	待つ
まつえい	末裔
まっか	真赤
まつかげ	松影
まつかぜ	松風
まっき	末期
まっくら	真暗
まっくろ	真黒
まつご	末期
まっこう	真向
まつざ	末座
まっさお	真青
まっさき	真先
まっさつ	抹殺
まっし	末子
まつじ	末寺
まつじつ	末日
まっしゃ	末社
まっしょう	抹消
まっしょう	末梢
まっしろ	真白
まっせ	末世
まっせき	末席
まっせつ	末節
まっそん	末孫
まつだい	末代
まったく	全く
まったん	末端
まっちゃ	抹茶
まってい	末弟
まつば	松葉
まつばやし	松林
まつばら	松原
まつび	末尾
まっぴつ	末筆
まつやま	松山
まつよう	末葉
まつりゅう	末流
まつる	祭る
まつろ	末路
まで	まで
まどい	惑い
まどお	間遠
まどぎわ	窓際
まどぐち	窓口
まなご	愛児
まなつ	真夏
まなび	学び
まなぶ	学ぶ
まにし	真西
まね	まね
まねき	招き
まねく	招く
まひ	麻痺
まひる	真昼
まふゆ	真冬
まほう	魔法
まま	まま
まま	ママ
ままこ	継子
ままちち	継父
まみず	真水
まめ	まめ
まめかす	豆粕
まめたん	豆炭
まめつ	摩滅
まもの	魔物
まもり	守り
まもる	守る
まやく	麻薬
まゆ	まゆ
まゆげ	眉毛
まゆずみ	眉墨
まよい	迷い
まよう	迷う
まよこ	真横
まり	まり
まるい	丸い
まるき	丸木
まるた	丸太
まるまる	丸々
まるみ	丸味
まれ	まれ
まわし	回し
まわた	真綿
まん	マン
まんいん	満員
まんえつ	満悦
まんえん	蔓延
まんが	漫画
まんかい	満開
まんかん	満干
まんき	満期
まんきつ	満喫
まんげつ	満月
まんこう	満腔
まんざ	満座
まんさい	満載
まんざい	漫才
まんさく	満作
まんざん	満山
まんしゅう	満州
まんじゅう	饅頭
まんじょう	満場
まんしん	慢心
まんしん	満身
まんすい	満水
まんせい	慢性
まんぜん	漫然
まんぞく	満足
まんだん	漫談
まんちゃく	瞞着
まんちょう	満潮
まんてん	満天
まんてん	満点
まんと	満都
まんにょう	万葉
まんのう	万能
まんびょう	万病
まんぷく	満腹
まんぽ	漫歩
まんまく	幔幕
まんまる	真丸
まんまん	満々
まんまん	漫々
まんめん	満面
まんもく	満目
まんゆう	漫遊
まんよう	万葉
まんりき	万力
まんりょう	満了
まんるい	満塁
み	−み
みうち	身内
みえ	見え
みかい	未開
みがき	磨き
みかく	味覚
みがく	磨く
みかた	見方
みかた	味方
みがら	身柄
みがる	身軽
みかん	未完
みき	御酒
みぎがわ	右側
みぎした	右下
みぎて	右手
みぎはし	右端
みぎひだり	右左
みぎよこ	右横
みけ	みけ
みけつ	未決
みけん	眉間
みこ	みこ
みこ	巫女
みごと	見事
みごろ	身頃
みこん	未婚
みさ	ミサ
みさい	未済
みじかい	短い
みしゅう	未収
みじゅく	未熟
みしょう	実生
みしょう	未詳
みじん	微塵
みす	みす
みす	ミス
みずあめ	水飴
みすい	未遂
みずいろ	水色
みずおけ	水桶
みずおと	水音
みずかがみ	水鏡
みずがめ	水瓶
みずから	自ら
みずぎ	水着
みずぎわ	水際
みずくさ	水草
みずぐすり	水薬
みずぐるま	水車
みずけ	水気
みずけむり	水煙
みずた	水田
みずたま	水玉
みずとり	水鳥
みずひき	水引
みずべ	水辺
みずまくら	水枕
みずむし	水虫
みずもの	水物
みずや	水屋
みせさき	店先
みぜに	身銭
みせばん	店番
みせや	店屋
みぜん	未然
みそ	味噌
みぞ	みぞ
みそら	み空
みそら	身空
みたけ	身丈
みだす	乱す
みだれ	乱れ
みち	未知
みぢか	身近
みちくさ	道草
みちじゅん	道順
みちなか	道中
みちのく	陸奥
みちばた	道端
みちびき	導き
みちびく	導く
みちみち	道々
みつ	みつ
みつうん	密雲
みっかい	密会
みつぎ	密議
みっきょう	密教
みつぐ	貢ぐ
みっけい	密計
みっこう	密航
みっこう	密行
みっこく	密告
みっし	密使
みつじ	密事
みっしつ	密室
みっしゅう	密集
みっしょ	密書
みっせい	密生
みっせつ	密接
みっそう	密葬
みつぞう	密造
みつだん	密談
みっちゃく	密着
みっつう	密通
みってい	密偵
みつど	密度
みつばい	密売
みっぷう	密封
みっぺい	密閉
みつやく	密約
みつゆ	密輸
みつりょう	密猟
みつりん	密林
みてい	未定
みどく	味読
みとめ	認め
みどりいろ	緑色
みどりご	嬰児
みなかみ	水上
みなさま	皆様
みなしご	孤児
みなそこ	水底
みなみかぜ	南風
みなわ	水泡
みにくい	醜い
みの	みの
みのう	未納
みのも	水面
みのり	実り
みのる	実る
みはば	身幅
みぶん	身分
みほん	見本
みまい	見舞
みまん	未満
みみあか	耳垢
みめ	みめ
みめい	未明
みもと	身許
みやくはく	脈搏
みゃくみゃく	脈々
みゃくらく	脈絡
みやざ	宮座
みやま	深山
みよ	御代
みょうあさ	明朝
みょうあん	妙案
みょうおう	明王
みょうが	冥加
みょうぎ	妙技
みょうけい	妙計
みょうじ	苗字
みょうしゅ	妙手
みょうしゅん	明春
みょうじょう	明星
みょうじん	明神
みょうたい	妙諦
みょうだい	名代
みょうちょう	明朝
みょうと	夫婦
みょうにち	明日
みょうねん	明年
みょうばん	明晩
みょうばん	明礬
みょうみ	妙味
みょうもく	名目
みょうやく	妙薬
みょうり	名利
みょうれい	妙齢
みらい	未来
みり	ミリ
みりょう	未了
みりょう	魅了
みりょく	魅力
みりん	味醂
みる	見る
みる	診る
みれん	未練
みわく	魅惑
みんい	民意
みんえい	民営
みんおく	民屋
みんか	民家
みんかん	民間
みんげい	民芸
みんけん	民権
みんこく	民国
みんじ	民事
みんしゃ	民社
みんしゅ	民主
みんしゅう	民衆
みんじょう	民情
みんしん	民心
みんせい	民政
みんせい	民生
みんせん	民選
みんぞく	民俗
みんぞく	民族
みんぽう	民法
みんよう	民謡
みんわ	民話
むい	無為
むえき	無益
むえん	無縁
むが	無我
むがい	無害
むかえ	迎え
むがく	無学
むかしばなし	昔話
むかしふう	昔風
むかしむかし	昔々
むき	むき
むき	向き
むき	無期
むぎ	むぎ
むぎあき	麦秋
むぎこ	麦粉
むきず	無傷
むぎちゃ	麦茶
むぎばたけ	麦畑
むぎぶえ	麦笛
むぎめし	麦飯
むぎゆ	麦湯
むきゅう	無窮
むきゅう	無給
むく	むく
むく	向く
むく	剥く
むく	無垢
むくい	報い
むくち	無口
むけ	向け
むけい	無形
むげん	夢幻
むげん	無限
むこう	無効
むこん	無根
むごん	無言
むざい	無罪
むさく	無策
むさぼる	貪る
むさん	無産
むざん	無慚
むし	無私
むし	無視
むじ	無地
むじつ	無実
むしば	虫歯
むしばむ	蝕む
むしゃ	武者
むしゅう	無臭
むじゅん	矛盾
むしょう	無償
むしょう	無性
むじょう	無上
むじょう	無常
むじょう	無情
むしょく	無職
むしょく	無色
むしん	無心
むじん	無尽
むす	むす
むすう	無数
むすこ	息子
むすび	結び
むすぶ	結ぶ
むせい	無声
むぜい	無税
むせん	無線
むせん	無銭
むそう	夢想
むそう	無双
むだ	むだ
むだ	無駄
むだい	無代
むだん	無断
むち	むち
むち	無知
むち	無恥
むちゃ	無茶
むちゅう	夢中
むちん	無賃
むてき	無敵
むてき	霧笛
むでん	無電
むどう	無道
むとどけ	無届
むなはば	胸幅
むに	無二
むねはば	胸幅
むねん	無念
むのう	無能
むはい	無配
むひ	無比
むひつ	無筆
むびょう	無病
むふう	無風
むへん	無辺
むほう	無法
むぼう	無謀
むほん	謀叛
むめい	無名
むやく	無益
むよう	無用
むよく	無欲
むら	むら
むらおさ	村長
むらがり	群り
むらくも	叢雲
むらさきいろ	紫色
むらざと	村里
むらさめ	村雨
むらびと	村人
むり	無理
むりょ	無慮
むりょう	無料
むりょう	無量
むりょう	無聊
むりょく	無力
むるい	無類
むれ	群れ
むろ	むろ
むろまち	室町
むろん	無論
めい	めい
めいあん	名案
めいあん	明暗
めいい	名医
めいか	名家
めいか	名歌
めいが	名画
めいかい	冥界
めいかい	明快
めいかく	明確
めいがら	銘柄
めいき	名器
めいき	明記
めいき	銘記
めいぎ	名義
めいきゅう	迷宮
めいきょく	名曲
めいく	名句
めいくん	名君
めいげつ	名月
めいげつ	明月
めいげん	名言
めいげん	明言
めいこう	名工
めいさい	明細
めいさい	迷彩
めいさく	名作
めいさつ	明察
めいさん	名産
めいし	名刺
めいし	名士
めいし	名詞
めいじ	明治
めいじ	明示
めいじつ	名実
めいしゅ	名手
めいしゅ	盟首
めいしゅ	銘酒
めいしょ	名所
めいしょう	名勝
めいしょう	名将
めいしょう	名称
めいじょう	名状
めいしん	迷信
めいじん	名人
めいすう	命数
めいせい	名声
めいせき	明晰
めいせん	銘仙
めいそう	名僧
めいそう	暝想
めいだい	命題
めいたつ	明達
めいちゅう	命中
めいちょ	名著
めいてい	酩酊
めいど	冥途
めいど	明度
めいとう	名刀
めいとう	名答
めいとう	明答
めいどう	鳴動
めいにち	命日
めいば	名馬
めいはく	明白
めいび	明媚
めいびん	明敏
めいぶつ	名物
めいぶん	名分
めいぶん	名文
めいぼ	名簿
めいほう	盟邦
めいぼう	名望
めいぼう	明眸
めいみゃく	命脈
めいむ	迷夢
めいめい	命名
めいめい	銘々
めいめつ	明滅
めいもう	迷妄
めいもく	名目
めいもく	瞑目
めいもん	名門
めいやく	盟約
めいゆう	名優
めいゆう	盟友
めいよ	名誉
めいり	名利
めいりょう	明瞭
めいれい	命令
めいろ	迷路
めいろう	明朗
めいろん	名論
めいわく	迷惑
めうえ	目上
めかた	目方
めがね	眼鏡
めがみ	女神
めぐすり	目薬
めぐみ	め組
めぐみ	恵み
めぐむ	恵む
めぐり	巡り
めさき	目先
めし	召し
めした	目下
めしつぶ	飯粒
めしどき	飯時
めしや	飯屋
めしゅうど	囚人
めじるし	目印
めす	メス
めす	召す
めだま	目玉
めっき	鍍金
めっきゃく	滅却
めっきん	滅菌
めっしつ	滅失
めっぽう	滅法
めつぼう	滅亡
めど	めど
めはな	目鼻
めばな	雌花
めぼし	目星
めも	メモ
めやす	目安
めんえき	免疫
めんえき	免役
めんえつ	面謁
めんか	綿花
めんかい	面会
めんかん	免官
めんきつ	面詰
めんきょ	免許
めんし	綿糸
めんしき	面識
めんじょ	免除
めんじょう	免状
めんじょう	面上
めんしょく	免職
めんぜい	免税
めんせき	面積
めんせき	面責
めんせつ	面接
めんぜん	面前
めんそ	免訴
めんそう	面相
めんだん	面談
めんつ	面子
めんどう	面倒
めんば	面罵
めんぷ	綿布
めんぼく	面目
めんみつ	綿密
めんめん	綿々
めんめん	面々
めんもく	面目
めんよう	面妖
めんるい	麺類
もう	もう
もうあい	盲愛
もうい	猛威
もうか	猛火
もうきん	猛禽
もうけ	設け
もうけ	儲け
もうけん	猛犬
もうこ	蒙古
もうじゃ	亡者
もうしゅう	妄執
もうじゅう	猛獣
もうじゅう	盲従
もうしん	妄信
もうしん	猛進
もうしん	盲進
もうじん	盲人
もうす	申す
もうせん	毛氈
もうぜん	猛然
もうそう	妄想
もうだ	猛打
もうだん	盲断
もうちょう	盲腸
もうてん	盲点
もうとう	毛頭
もうどう	妄動
もうどく	猛毒
もうねん	妄念
もうばく	猛爆
もうはつ	毛髪
もうひつ	毛筆
もうひょう	妄評
もうふ	毛布
もうまい	蒙昧
もうまく	網膜
もうもう	濛々
もうもく	盲目
もうら	網羅
もうれつ	猛烈
もうろう	朦朧
もぎ	模擬
もぐ	もぐ
もくぎょ	木魚
もくげい	目迎
もくげき	目撃
もくざい	木材
もくさつ	黙殺
もくさん	目算
もくし	黙止
もくし	黙視
もくじ	目次
もくせい	木星
もくせい	木製
もくぜん	目前
もくそう	黙想
もくそう	目送
もくぞう	木造
もくそく	目測
もくたん	木炭
もくてき	目的
もくとう	黙祷
もくどく	黙読
もくにん	黙認
もくば	木馬
もくはん	木版
もくひ	黙秘
もくひょう	目標
もくめ	木目
もくもく	黙々
もくやく	黙約
もくよう	木曜
もくよく	沐浴
もぐる	潜る
もくれい	黙礼
もくれい	目礼
もくろく	目録
もけい	模型
もこ	模糊
もさく	模索
もし	もし
もじ	文字
もしゅ	喪主
もしょう	喪章
もす	燃す
もず	もず
もぞう	模造
もたらす	齎す
もち	持ち
もちあい	保合
もちづき	望月
もちゅう	喪中
もつ	もつ
もつ	以つ
もつ	持つ
もっか	黙過
もっか	目下
もっきょ	黙許
もっきん	木琴
もっけい	黙契
もっこう	木工
もっこう	黙考
もっとも	最も
もと	もと
もときん	元金
もどす	戻す
もとね	元値
もとぶね	本船
もとめ	求め
もどる	戻る
もなか	最中
もの	もの
ものおと	物音
ものかげ	物陰
ものぐさ	物臭
ものごころ	物心
ものごし	物腰
ものごと	物事
ものさし	物差
ものび	物日
ものみ	物見
もはん	模範
もふく	喪服
もほう	模倣
もみじ	紅葉
もむ	もむ
もめん	木綿
もも	もも
ももいろ	桃色
ももひき	股引
ももやま	桃山
もよう	模様
もよおし	催し
もよおす	催す
もらい	貰い
もり	守り
もり	盛り
もり	漏り
もる	もる
もる	盛る
もれ	漏れ
もろて	双手
もんえい	門衛
もんか	門下
もんがい	門外
もんく	文句
もんげん	門限
もんこ	門戸
もんさつ	門札
もんし	悶死
もんし	門歯
もんじ	文字
もんじょ	文書
もんしょう	紋章
もんじん	門人
もんぜつ	悶絶
もんぜん	門前
もんだい	問題
もんちゃく	悶着
もんちゅう	門柱
もんつき	紋付
もんてい	門弟
もんどう	問答
もんばつ	門閥
もんばん	門番
もんぶ	文部
もんぷく	紋服
もんもう	文盲
もんもん	悶々
やあ	やあ
やい	やい
やいん	夜陰
やえ	八重
やえい	野営
やおもて	矢面
やかい	夜会
やがい	野外
やがく	夜学
やかた	屋形
やかん	夜間
やかん	薬罐
やき	焼き
やき	夜気
やぎ	やぎ
やきゅう	野球
やぎょう	夜業
やきょく	夜曲
やきん	冶金
やきん	夜勤
やく	やく
やく	焼く
やぐ	夜具
やくいん	役員
やくがら	役柄
やくご	訳語
やくざい	薬剤
やくさつ	薬殺
やくし	薬師
やくし	訳詩
やくしゃ	役者
やくしゃ	訳者
やくしゅつ	訳出
やくしょ	役所
やくしょ	訳書
やくじょ	躍如
やくじょう	約定
やくしん	躍進
やくすう	約数
やくそう	役僧
やくそう	薬草
やくそく	約束
やくどう	躍動
やくとく	役得
やくどく	訳読
やくどし	厄年
やくにん	役人
やくば	役場
やくび	厄日
やくびょう	疫病
やくひん	薬品
やくぶつ	薬物
やくぶん	約分
やくぶん	訳文
やくみ	薬味
やくめ	役目
やくよう	薬用
やぐるま	矢車
やくわり	役割
やけ	やけ
やけい	夜景
やけい	夜警
やけん	野犬
やこう	夜行
やごう	野合
やさい	野菜
やさがた	優形
やさき	矢先
やし	やし
やし	野師
やじ	やじ
やしき	屋敷
やしない	養い
やしなう	養う
やしゃ	夜叉
やしゅ	野趣
やしゅう	夜襲
やじゅう	野獣
やしょく	夜食
やじるし	矢印
やしん	野心
やじん	野人
やす	やす
やすい	安い
やすみ	休み
やすむ	休む
やすめ	休め
やすもの	安物
やせ	痩せ
やせい	野性
やせい	野生
やせん	野戦
やぜん	夜前
やたい	屋台
やちゅう	夜中
やちょう	野鳥
やちん	家賃
やっ	ヤッ
やつ	やつ
やっかい	厄介
やっかん	約款
やっき	躍起
やっきょく	薬局
やつばら	奴原
やとう	野党
やどちょう	宿帳
やどちん	宿賃
やどや	宿屋
やどり	宿り
やどる	宿る
やなぎごし	柳腰
やに	やに
やぬし	家主
やね	屋根
やはず	矢筈
やはん	夜半
やばん	野蛮
やひ	野卑
やぶみ	矢文
やぶる	破る
やぶん	夜分
やぼ	やぼ
やぼう	野望
やまあい	山間
やまうば	山姥
やまおく	山奥
やまおとこ	山男
やまが	山家
やまかげ	山陰
やまかぜ	山風
やまかわ	山川
やまき	山気
やまぐに	山国
やまけ	山気
やまざと	山里
やまし	山師
やまじ	山路
やますそ	山裾
やまだ	山田
やまて	山手
やまでら	山寺
やまと	大和
やまなか	山中
やまばん	山番
やまぶし	山伏
やまやま	山々
やまんば	山姥
やみ	やみ
やみね	闇値
やむ	やむ
やむ	病む
やめ	止め
やや	やや
やゆ	揶揄
やらい	夜来
やる	やる
やる	演る
やろう	野郎
やわ	夜話
ゆあか	湯垢
ゆいいつ	唯一
ゆいごん	遺言
ゆいしょ	由緒
ゆいのう	結納
ゆう	結う
ゆうあい	友愛
ゆうあく	優渥
ゆうい	優位
ゆうい	有為
ゆういん	誘因
ゆういん	誘引
ゆううつ	憂欝
ゆうえき	有益
ゆうえつ	優越
ゆうおう	勇往
ゆうが	優雅
ゆうかい	誘拐
ゆうかい	融解
ゆうがい	有害
ゆうがく	遊学
ゆうがすみ	夕霞
ゆうかぜ	夕風
ゆうがた	夕方
ゆうかん	勇敢
ゆうかん	憂患
ゆうかん	有閑
ゆうかん	夕刊
ゆうき	勇気
ゆうき	有期
ゆうき	有機
ゆうぎ	友誼
ゆうぎ	遊戯
ゆうきゅう	悠久
ゆうきゅう	有給
ゆうきゅう	遊休
ゆうきょう	遊興
ゆうぎり	夕霧
ゆうきん	遊金
ゆうぐう	優遇
ゆうぐも	夕雲
ゆうぐん	友軍
ゆうけい	有形
ゆうけい	夕景
ゆうげい	遊芸
ゆうげき	遊撃
ゆうけむり	夕煙
ゆうけん	郵券
ゆうげん	幽玄
ゆうげん	有限
ゆうこう	友好
ゆうこう	有効
ゆうごう	融合
ゆうこく	憂国
ゆうこく	夕刻
ゆうこん	雄渾
ゆうざい	有罪
ゆうさん	有産
ゆうし	勇士
ゆうし	勇姿
ゆうし	有志
ゆうし	遊資
ゆうし	融資
ゆうじ	有事
ゆうしき	有識
ゆうしゃ	勇者
ゆうしゅう	優秀
ゆうしゅう	幽囚
ゆうしゅう	憂愁
ゆうしゅう	有終
ゆうじゅう	優柔
ゆうしゅつ	湧出
ゆうじょ	宥恕
ゆうじょ	遊女
ゆうしょう	優勝
ゆうしょう	勇将
ゆうしょう	有償
ゆうじょう	友情
ゆうしょく	憂色
ゆうしょく	有色
ゆうしょく	夕食
ゆうじん	友人
ゆうすい	幽邃
ゆうすう	有数
ゆうずう	融通
ゆうせい	優勢
ゆうせい	優性
ゆうせい	遊星
ゆうせい	郵政
ゆうぜい	遊説
ゆうぜい	郵税
ゆうせん	優先
ゆうせん	有線
ゆうぜん	友禅
ゆうぜん	悠然
ゆうそう	勇壮
ゆうそう	郵送
ゆうそく	有職
ゆうぞら	夕空
ゆうだ	遊惰
ゆうたい	優待
ゆうたい	勇退
ゆうだい	雄大
ゆうだち	夕立
ゆうだん	勇断
ゆうち	誘致
ゆうちょう	悠長
ゆうづき	夕月
ゆうと	雄図
ゆうとう	優等
ゆうとう	遊蕩
ゆうどう	誘導
ゆうとく	有徳
ゆうどく	有毒
ゆうに	優に
ゆうのう	有能
ゆうはん	雄藩
ゆうはん	夕飯
ゆうひ	雄飛
ゆうひ	夕日
ゆうび	優美
ゆうひつ	祐筆
ゆうびん	郵便
ゆうふ	有夫
ゆうぶ	勇武
ゆうふく	裕福
ゆうべ	夕べ
ゆうへい	幽閉
ゆうべん	雄弁
ゆうほ	遊歩
ゆうほう	友邦
ゆうぼう	有望
ゆうぼく	遊牧
ゆうみん	遊民
ゆうめい	勇名
ゆうめい	有名
ゆうめし	夕飯
ゆうもう	勇猛
ゆうもん	憂悶
ゆうやく	勇躍
ゆうゆう	悠々
ゆうよ	猶予
ゆうよう	悠揚
ゆうよう	有用
ゆうよく	遊弋
ゆうらく	遊楽
ゆうらん	遊覧
ゆうり	有利
ゆうり	遊離
ゆうりょ	憂慮
ゆうりょう	優良
ゆうりょう	有料
ゆうりょう	遊猟
ゆうりょく	有力
ゆうれい	幽霊
ゆうれき	遊歴
ゆうれつ	優劣
ゆうわ	宥和
ゆうわ	融和
ゆうわく	誘惑
ゆえに	故に
ゆえん	油煙
ゆえん	由縁
ゆおう	硫黄
ゆかい	愉快
ゆかいた	床板
ゆかうえ	床上
ゆかした	床下
ゆき	行き
ゆきぐに	雪国
ゆきぐも	雪雲
ゆきぞら	雪空
ゆきみ	雪見
ゆく	行く
ゆく	逝く
ゆくすえ	行末
ゆげ	湯気
ゆけつ	輸血
ゆけむり	湯煙
ゆごう	癒合
ゆこく	諭告
ゆさん	遊山
ゆしゅつ	輸出
ゆず	ゆず
ゆずる	譲る
ゆせい	油井
ゆそう	輸送
ゆだん	油断
ゆちゃく	癒着
ゆでん	油田
ゆどの	湯殿
ゆにゅう	輸入
ゆびさき	指先
ゆびわ	指輪
ゆみず	湯水
ゆみや	弓矢
ゆめじ	夢路
ゆめまぼろし	夢幻
ゆめみ	夢見
ゆもと	湯元
ゆらい	由来
ゆり	ゆり
ゆる	揺る
ゆるい	緩い
ゆるし	許し
ゆるす	許す
ゆるみ	弛み
ゆれ	揺れ
よい	よい
よいみや	宵宮
よいん	余韻
よう	よう
よう	酔う
ようあん	溶暗
ようい	容易
ようい	用意
よういく	養育
よういん	要員
よういん	要因
ようえい	揺曳
ようえき	溶液
ようえん	妖艶
ようか	洋貨
ようが	洋画
ようが	陽画
ようかい	妖怪
ようかい	容喙
ようかい	溶解
ようがい	要害
ようがく	洋学
ようがく	洋楽
ようかん	洋館
ようかん	羊羹
ようがん	熔岩
ようき	容器
ようき	陽気
ようぎ	容疑
ようきゅう	要求
ようぎょ	養魚
ようきょく	謡曲
ようきょく	陽極
ようぐ	用具
ようくん	幼君
ようけい	養鶏
ようけつ	要訣
ようけん	用件
ようけん	要件
ようご	擁護
ようご	用語
ようご	養護
ようこう	洋行
ようこう	要港
ようこう	要綱
ようこう	要項
ようこう	陽光
ようさい	洋裁
ようさい	要塞
ようざい	用材
ようさん	養蚕
ようし	容姿
ようし	洋紙
ようし	用紙
ようし	要旨
ようし	養子
ようじ	幼児
ようじ	幼時
ようじ	楊子
ようじ	用事
ようしき	様式
ようしつ	洋室
ようしゃ	容赦
ようしゃく	用尺
ようじゃく	幼弱
ようしゅ	洋酒
ようしゅん	陽春
ようしょ	洋書
ようしょ	要所
ようじょ	幼女
ようじょ	養女
ようしょう	幼少
ようしょう	要衝
ようじょう	洋上
ようじょう	養生
ようしょく	容色
ようしょく	洋食
ようしょく	要職
ようしょく	養殖
ようじん	用心
ようじん	要人
ようす	様子
ようすい	用水
ようせい	妖精
ようせい	要請
ようせい	陽性
ようせい	養成
ようせき	容積
ようせつ	熔接
ようせつ	夭折
ようせん	傭船
ようせん	用箋
ようそ	要素
ようそう	様相
ようそう	洋装
ようたい	様態
ようたい	要諦
ようだい	容態
ようだん	用談
ようだん	要談
ようち	幼稚
ようち	用地
ようちゅう	幼虫
ようちょう	膺懲
ようつい	腰椎
ようてい	要諦
ようてん	要点
ようと	用途
ようど	用度
ようとん	養豚
ように	陽に
ようにん	傭人
ようにん	容認
ようにん	用人
ようねん	幼年
ようはい	遥拝
ようはつ	洋髪
ようび	曜日
ようひん	洋品
ようひん	用品
ようふ	用布
ようふ	養父
ようぶ	洋舞
ようふう	洋風
ようふく	洋服
ようぶん	養分
ようへい	傭兵
ようへい	用兵
ようべん	用便
ようぼ	養母
ようほう	用法
ようぼう	容貌
ようぼう	要望
ようま	洋間
ようみゃく	葉脈
ようみょう	幼名
ようむ	用務
ようむ	要務
ようめい	幼名
ようめい	用命
ようめん	葉面
ようもう	羊毛
ようもく	要目
ようやく	要約
ようゆう	熔融
ようよう	洋々
ようよう	要用
ようらん	揺籃
ようらん	要覧
ようりつ	擁立
ようりょう	容量
ようりょう	用量
ようりょう	要領
ようれい	用例
ようろ	要路
ようろう	養老
ようん	余蘊
よか	予科
よか	余暇
よかぜ	夜風
よかん	予感
よかん	余寒
よき	予期
よぎ	夜着
よぎ	余儀
よぎ	余技
よきょう	余興
よぎり	夜霧
よきん	預金
よく	よく
よくあさ	翌朝
よくあつ	抑圧
よくげつ	翌月
よくさん	翼賛
よくし	抑止
よくしつ	浴室
よくじつ	翌日
よくじょう	欲情
よくじょう	浴場
よくしん	欲心
よくせい	抑制
よくち	沃地
よくちょう	翌朝
よくど	沃土
よくとし	翌年
よくねん	翌年
よくばん	翌晩
よくぼう	欲望
よくめ	欲目
よくや	沃野
よくよう	抑揚
よくりゅう	抑留
よけい	余計
よけん	予見
よげん	予言
よこ	よこ
よご	予後
よこあな	横穴
よこいと	横糸
よこう	予行
よこがお	横顔
よこく	予告
よこちょう	横丁
よこづな	横綱
よこつら	横面
よこて	横手
よこで	横手
よこなみ	横波
よこばら	横腹
よこぶえ	横笛
よこみち	横道
よこめ	横目
よごれ	汚れ
よざい	余罪
よさむ	夜寒
よさん	予算
よし	よし
よじ	余事
よしゅう	予習
よじょう	余剰
よじょう	余情
よしん	余震
よじん	余人
よじん	余燼
よす	よす
よすみ	四隅
よせ	寄席
よせい	余勢
よせい	余生
よせん	予選
よそ	よそ
よそう	予想
よそおい	装い
よそおう	装う
よそく	予測
よぞら	夜空
よだん	予断
よだん	余談
よち	予知
よち	余地
よつ	よつ
よっきゅう	欲求
よつゆ	夜露
よてい	予定
よとう	与党
よとぎ	夜伽
よとく	余得
よとく	余徳
よどみ	淀み
よなか	夜中
よなが	夜長
よねつ	余熱
よねん	余念
よは	余波
よはく	余白
よばなし	夜話
よばん	夜番
よび	呼び
よび	予備
よびこ	呼子
よびょう	余病
よびりん	呼鈴
よぶ	呼ぶ
よふん	余憤
よぶん	余分
よへい	余弊
よほう	予報
よぼう	予防
よぼう	輿望
よみ	読み
よみせ	夜店
よみち	夜道
よむ	詠む
よむ	読む
よめ	夜目
よめい	余命
よも	四方
よやく	予約
よゆう	余裕
よよ	よよ
より	より
より	寄り
より	搓り
よりょく	余力
よる	よる
よる	因る
よる	寄る
よる	拠る
よる	選る
よる	縒る
よろく	余録
よろこび	喜び
よろこぶ	喜ぶ
よろん	輿論
よわ	よわ
よわ	夜話
よわ	余話
よわい	弱い
よわき	弱気
よわごし	弱腰
よわね	弱音
よわび	弱火
よわみ	弱み
よわむし	弱虫
よわる	弱る
よん	よん
よんじゆう	四十
よんせん	四千
よんひゃく	四百
らいい	来意
らいう	雷雨
らいかい	来会
らいき	来期
らいきゃく	来客
らいげき	雷撃
らいげつ	来月
らいさん	礼讃
らいしゅう	来襲
らいしゅう	来週
らいしゅん	来春
らいじょう	来場
らいしん	来信
らいせ	来世
らいだん	来談
らいちゃく	来着
らいちょう	来朝
らいてん	来店
らいでん	来電
らいどう	雷同
らいにち	来日
らいねん	来年
らいはい	礼拝
らいはる	来春
らいびょう	癩病
らいひん	来賓
らいほう	来訪
らいめい	雷鳴
らいらく	磊落
らいりん	来臨
らいれき	来歴
らくいん	烙印
らくえん	楽園
らくご	落伍
らくご	落語
らくさ	落差
らくさつ	落札
らくじつ	落日
らくしゅ	落手
らくじょう	落城
らくせい	落成
らくせん	落選
らくだい	落第
らくたん	落胆
らくてん	楽天
らくど	楽土
らくのう	酪農
らくば	落馬
らくばん	落磐
らくほく	洛北
らくめい	落命
らくよう	落葉
らくらい	落雷
らくらく	楽々
らくるい	落涙
らしん	裸身
らせん	螺旋
らたい	裸体
らち	拉致
らっか	落下
らっか	落花
らっかん	楽観
らつわん	辣腕
られつ	羅列
らん	らん
らんうん	乱雲
らんおう	卵黄
らんがい	欄外
らんかく	濫獲
らんがく	蘭学
らんかん	欄干
らんぎょう	乱行
らんげき	乱撃
らんざつ	乱雑
らんし	乱視
らんじゅく	爛熟
らんしょう	濫觴
らんしん	乱心
らんせい	乱世
らんせい	卵生
らんせん	乱戦
らんそう	卵巣
らんぞう	乱造
らんだ	乱打
らんとう	乱闘
らんどく	乱読
らんにゅう	乱入
らんぱく	卵白
らんばつ	乱伐
らんぱつ	濫発
らんぴ	濫費
らんぴつ	乱筆
らんぶ	乱舞
らんぼう	乱暴
らんま	欄間
らんまん	爛漫
らんみゃく	乱脈
らんよう	乱用
らんらん	爛々
らんりつ	乱立
りえき	利益
りえん	離縁
りか	理科
りかい	理解
りがい	利害
りがく	理学
りかん	離間
りき	利器
りきえん	力演
りきがく	力学
りきさく	力作
りきし	力士
りきせつ	力説
りきせん	力戦
りきそう	力走
りきてん	力点
りきとう	力闘
りきむ	力む
りきゅう	離宮
りきょう	離京
りきりょう	力量
りくぐん	陸軍
りくし	陸士
りくじょう	陸上
りくせい	陸棲
りくぞく	陸続
りくだな	陸棚
りくち	陸地
りくつ	理屈
りくとう	陸稲
りくろ	陸路
りけん	利権
りこ	利己
りご	俚語
りこう	利巧
りこう	履行
りごう	離合
りこん	離婚
りさい	罹災
りざい	理財
りさん	離散
りし	利子
りじ	理事
りしゅう	履修
りじゅん	利潤
りしょく	利殖
りす	リス
りすい	離水
りせい	理性
りそう	理想
りそく	利息
りた	利他
りだつ	離脱
りち	理知
りちぎ	律儀
りつあん	立案
りっきゃく	立脚
りっきょう	陸橋
りっけん	立憲
りっし	立志
りっしゅう	立秋
りっしゅん	立春
りっしょう	立証
りっしょく	立食
りっしん	立身
りつぜん	慄然
りつぞう	立像
りったい	立体
りっち	立地
りっとう	立冬
りつどう	律動
りっぱ	立派
りっぷく	立腹
りっぽう	立方
りっぽう	立法
りつろん	立論
りてい	里程
りてん	利点
りとく	利得
りにち	離日
りにゅう	離乳
りねん	理念
りはつ	理髪
りはん	離反
りひ	理非
りびょう	罹病
りべつ	離別
りめん	裏面
りゃくが	略画
りゃくご	略語
りゃくごう	略号
りゃくじ	略字
りゃくしき	略式
りゃくしゅ	略取
りゃくじゅつ	略述
りゃくしょう	略称
りゃくず	略図
りゃくそう	略装
りゃくだつ	略奪
りゃくでん	略伝
りゃくふ	略譜
りゃくふく	略服
りゃくれき	略歴
りゃっき	略記
りゆう	理由
りゅうあん	硫安
りゅうい	留意
りゅういき	流域
りゅういん	溜飲
りゅうかい	流会
りゅうがく	留学
りゅうかん	流感
りゅうき	隆起
りゅうぎ	流儀
りゅうきゅう	琉球
りゅうぐう	竜宮
りゅうけい	流刑
りゅうけつ	流血
りゅうげん	流言
りゅうこう	流行
りゅうさん	硫酸
りゅうざん	流産
りゅうし	粒子
りゅうしつ	流失
りゅうしゅつ	流出
りゅうしょう	隆昌
りゅうず	竜頭
りゅうすい	流水
りゅうせい	流星
りゅうせい	隆盛
りゅうたい	流体
りゅうち	留置
りゅうちょう	流暢
りゅうつう	流通
りゅうどう	流動
りゅうにゅう	流入
りゅうにん	留任
りゅうは	流派
りゅうひょう	流氷
りゅうべつ	留別
りゅうぼく	流木
りゅうみん	流民
りゅうよう	流用
りゅうりゅう	隆々
りゅうれい	流麗
りゅうろ	流露
りよう	利用
りよう	理容
りよう	俚謡
りょうあし	両足
りょういき	領域
りょういん	両院
りょううで	両腕
りょうえん	良縁
りょうえん	遼遠
りょうか	良家
りょうが	凌駕
りょうかい	了解
りょうかい	領海
りょうがえ	両替
りょうがわ	両側
りょうかん	猟官
りょうがん	両岸
りょうがん	両眼
りょうき	漁期
りょうきょく	両極
りょうきん	料金
りょうくう	領空
りょうけ	両家
りょうけ	良家
りょうけい	菱形
りょうけい	量刑
りょうけん	了見
りょうけん	料簡
りょうけん	猟犬
りょうこう	良好
りょうこう	良港
りょうこく	両国
りょうさい	良妻
りょうさん	量産
りょうし	漁師
りょうし	両氏
りょうし	猟師
りょうじ	療治
りょうじ	領事
りょうしき	良識
りょうしつ	良質
りょうじつ	両日
りょうしゃ	両者
りょうしゅ	領主
りょうしゅう	領収
りょうしゅう	領袖
りょうじゅう	猟銃
りょうしょ	良書
りょうしょう	了承
りょうしょく	糧食
りょうじょく	凌辱
りょうしん	両親
りょうしん	良心
りょうせい	両性
りょうせい	両棲
りょうせん	稜線
りょうぜん	瞭然
りょうたん	両端
りょうだん	両断
りょうち	領地
りょうちょ	良著
りょうて	両手
りょうてい	料亭
りょうど	領土
りょうとう	両党
りょうとう	両刀
りょうない	領内
りょうにん	両人
りょうば	漁場
りょうば	猟場
りょうひ	良否
りょうふう	涼風
りょうぶん	領分
りょうほう	両方
りょうほう	療法
りょうまつ	糧秣
りょうみん	良民
りょうめん	両面
りょうやく	良薬
りょうゆう	療友
りょうゆう	良友
りょうゆう	領有
りょうよう	両用
りょうよう	療養
りょうよく	両翼
りょうらん	繚乱
りょうり	料理
りょうりつ	両立
りょうりん	両輪
りょうわき	両脇
りょがい	慮外
りょかく	旅客
りょかん	旅館
りょきゃく	旅客
りよく	利欲
りょくいん	緑陰
りょくしょく	緑色
りょくち	緑地
りょくちゃ	緑茶
りょくや	緑野
りょけん	旅券
りょこう	旅行
りょしゅう	旅愁
りょしゅう	虜囚
りょじょう	旅情
りょじん	旅人
りょそう	旅装
りょっか	緑化
りょてい	旅程
りょひ	旅費
りら	リラ
りりく	離陸
りりつ	利率
りれき	履歴
りろ	理路
りろん	理論
りん	リン
りんう	霖雨
りんか	隣家
りんかい	臨海
りんかく	輪郭
りんかん	林間
りんき	臨機
りんぎょう	林業
りんけい	鱗形
りんげつ	臨月
りんけん	臨検
りんこ	凛乎
りんこう	燐光
りんごく	隣国
りんさく	輪作
りんさん	林産
りんさん	燐酸
りんじ	臨時
りんしつ	隣室
りんしゃ	臨写
りんじゅう	臨終
りんしょう	臨床
りんしょう	輪唱
りんじょう	臨場
りんしょく	吝嗇
りんじん	隣人
りんせき	臨席
りんせき	隣席
りんせつ	隣接
りんそん	隣村
りんと	凛と
りんね	輪廻
りんばん	輪番
りんぽ	隣保
りんぽう	隣邦
りんも	臨模
りんや	林野
りんらく	淪落
りんり	倫理
りんりつ	林立
りんれつ	凛烈
るいか	累加
るいけい	累計
るいけい	類型
るいご	類語
るいじ	累次
るいじ	類似
るいしょ	類書
るいしょう	類焼
るいしん	累進
るいすい	類推
るいせき	累積
るいぞう	累増
るいだい	累代
るいべつ	類別
るいるい	累々
るいれい	類例
るけい	流刑
るざい	流罪
るす	留守
るたく	流謫
るてん	流転
るび	ルビ
るふ	流布
るみん	流民
るり	瑠璃
るろう	流浪
れいか	零下
れいかい	例会
れいかい	霊界
れいがい	例外
れいがい	冷害
れいかん	霊感
れいき	冷気
れいぎ	礼儀
れいきゃく	冷却
れいきゅう	霊柩
れいきん	礼金
れいぐう	冷遇
れいぐう	礼遇
れいけい	令兄
れいけい	令閨
れいけつ	冷血
れいげん	霊験
れいこう	励行
れいこく	冷酷
れいこん	霊魂
れいさい	例祭
れいさい	零細
れいしき	礼式
れいしょう	例証
れいしょう	冷笑
れいじょう	令嬢
れいじょう	令状
れいじょう	礼状
れいじょう	霊場
れいじん	麗人
れいすい	冷水
れいせい	冷静
れいせつ	礼節
れいせん	冷戦
れいぜん	霊前
れいそう	礼装
れいぞう	冷蔵
れいそく	令息
れいぞく	隷属
れいだい	例題
れいたん	冷淡
れいち	霊地
れいちょう	霊長
れいてい	令弟
れいてん	零点
れいとう	冷凍
れいねん	例年
れいはい	礼拝
れいはい	零敗
れいばい	霊媒
れいひつ	麗筆
れいびょう	霊廟
れいふく	礼服
れいぶん	例文
れいほう	礼法
れいほう	礼砲
れいぼう	冷房
れいみょう	霊妙
れいめい	令名
れいめい	黎明
れいらく	零落
れいり	怜悧
れいりょう	冷涼
れいろう	玲瓏
れいわ	例話
れきし	歴史
れきし	轢死
れきせん	歴戦
れきぜん	歴然
れきだい	歴代
れきにん	歴任
れきほう	歴訪
れきれき	歴々
れっか	烈火
れっき	列記
れっきょ	列挙
れっきょう	列強
れっこく	列国
れつざ	列座
れっしゃ	列車
れっせい	劣勢
れっせい	劣性
れっせき	列席
れっとう	列島
れっとう	劣等
れっぷ	烈婦
れっぷう	烈風
れつれつ	烈々
れふ	レフ
れる	れる
れんあい	恋愛
れんか	廉価
れんが	煉瓦
れんが	連歌
れんかん	連関
れんき	連記
れんきゅう	連休
れんけい	連携
れんけつ	廉潔
れんけつ	連結
れんこ	連呼
れんこう	連行
れんごう	連合
れんこん	蓮根
れんさ	連鎖
れんざ	連坐
れんさい	連載
れんさく	連作
れんざん	連山
れんじつ	連日
れんじゅ	連珠
れんしゅう	練習
れんじゅう	連中
れんしょ	連署
れんしょう	連勝
れんせん	連戦
れんそう	連想
れんぞく	連続
れんたい	連帯
れんたい	連隊
れんだく	連濁
れんたつ	練達
れんたん	煉炭
れんだん	連弾
れんち	廉恥
れんちゅう	連中
れんちょく	廉直
れんどう	連動
れんばい	廉売
れんぱい	連敗
れんぱつ	連発
れんびん	憐憫
れんぼ	恋慕
れんぽう	連峰
れんぽう	連邦
れんま	練磨
れんめい	連名
れんめい	連盟
れんめん	連綿
れんや	連夜
れんらく	連絡
れんりつ	連立
れんるい	連累
れんれん	恋々
ろうえい	朗詠
ろうえい	漏洩
ろうえき	労役
ろうか	廊下
ろうかい	老獪
ろうかく	楼閣
ろうがん	老眼
ろうきゅう	篭球
ろうきゅう	老朽
ろうきょ	篭居
ろうきょう	老境
ろうきょく	浪曲
ろうく	労苦
ろうく	老躯
ろうこ	牢乎
ろうご	老後
ろうこう	老巧
ろうこう	陋巷
ろうごく	牢獄
ろうさい	老妻
ろうさく	労作
ろうし	労使
ろうし	労資
ろうじゅく	老熟
ろうじょ	老女
ろうじょう	篭城
ろうしん	老臣
ろうじん	老人
ろうすい	漏水
ろうすい	老衰
ろうせい	老成
ろうぜき	狼藉
ろうそ	労組
ろうそく	蝋燭
ろうたい	老体
ろうでん	漏電
ろうと	漏斗
ろうどう	労働
ろうどく	朗読
ろうにん	浪人
ろうねん	老年
ろうのう	労農
ろうば	老婆
ろうば	老馬
ろうばい	狼狽
ろうひ	浪費
ろうふ	老父
ろうぼ	老母
ろうほう	朗報
ろうむ	労務
ろうや	牢屋
ろうらく	篭絡
ろうりょく	労力
ろうれい	老齢
ろうれつ	陋劣
ろうれん	老練
ろえい	露営
ろか	濾過
ろかく	鹵獲
ろくおん	録音
ろくしち	六七
ろくじゅう	六十
ろくしょう	緑青
ろくせん	六千
ろくまく	肋膜
ろけ	ロケ
ろけん	露見
ろご	露語
ろこつ	露骨
ろじ	路次
ろじ	路地
ろじ	露地
ろしゅつ	露出
ろじょう	路上
ろせん	路線
ろだい	露台
ろっこつ	肋骨
ろっぴゃく	六百
ろっぽう	六法
ろてん	露天
ろてん	露店
ろてん	露点
ろと	露都
ろとう	路頭
ろどん	魯鈍
ろは	ロハ
ろば	ろば
ろばた	炉端
ろへん	炉辺
ろぼう	路傍
ろめい	露命
ろれつ	呂律
ろんがい	論外
ろんかく	論客
ろんぎ	論議
ろんきゃく	論客
ろんきゅう	論及
ろんきゅう	論究
ろんきょ	論拠
ろんご	論語
ろんこう	論考
ろんこく	論告
ろんし	論旨
ろんしゃ	論者
ろんじゅつ	論述
ろんしょう	論証
ろんせつ	論説
ろんせん	論戦
ろんそう	論争
ろんだい	論題
ろんだん	論壇
ろんちょう	論調
ろんてき	論敵
ろんてん	論点
ろんなん	論難
ろんぱ	論破
ろんばく	論駁
ろんぴょう	論評
ろんぶん	論文
ろんぽう	論法
ろんり	論理
わあ	わあ
わあ	ワア
わいきょく	歪曲
わいざつ	猥雑
わいせつ	猥褻
わいほん	猥本
わいろ	賄賂
わえい	和英
わおん	和音
わか	和歌
わが	わが
わかい	若い
わかい	和解
わかうど	若人
わかぎ	若木
わかくさ	若草
わかげ	若気
わかごま	若駒
わかさま	若様
わかしゅ	若衆
わかぞう	若造
わかて	若手
わかどり	若鶏
わかな	若菜
わかば	若葉
わかめ	若芽
わかもの	若者
わかれ	別れ
わかん	和漢
わき	ワキ
わき	和気
わぎ	和議
わきが	腋臭
わきがわ	脇側
わきざし	脇差
わきせん	脇線
わきたけ	脇丈
わきぬの	脇布
わきばら	脇腹
わきやく	脇役
わく	わく
わく	沸く
わくせい	惑星
わくでき	惑溺
わくらん	惑乱
わけ	わけ
わけ	分け
わごう	和合
わこうど	若人
わさい	和裁
わし	わし
わし	和紙
わしつ	和室
わじゅつ	話術
わずらい	煩い
わすれ	忘れ
わせ	早稲
わせい	和声
わせい	和製
わそう	和装
わた	わた
わだい	話題
わたくしごと	私事
わたくしりつ	私立
わたし	渡し
わたす	渡す
わたり	渡り
わたる	渡る
わて	わて
わな	わな
わに	わに
わびごと	詫事
わふう	和風
わふく	和服
わぶん	和文
わぼく	和睦
わほん	和本
わやく	和訳
わよう	和様
わよう	和洋
わらい	笑い
わらう	笑う
わらじ	草鞋
わらべうた	童歌
わりあい	割合
わりに	割に
わる	割る
わるい	悪い
わるぎ	悪気
わるくち	悪口
わるもの	悪者
わるよい	悪酔
われ	割れ
わん	ワン
わんきょく	彎曲
わんしょう	腕章
わんぱく	腕白
わんりゅう	湾流
わんりょく	腕力
