あいくるしい	愛くるしい
あおがえる	あおがえる
あおむける	あおむける
あかでみい	アカデミー
あかとんぼ	あかとんぼ
あからさま	あからさま
あかんべい	あかんべい
あきすねらい	空巣ねらい
あきたりる	飽き足りる
あきっぽい	飽きっぽい
あきどまり	あきどまり
あきらめる	あきらめる
あきれかえる	あきれ返る
あきれすけん	アキレス腱
あくせんと	アクセント
あげおろし	上げ下ろし
あけくれる	明け暮れる
あけのみょうじょう	明けの明星
あけはなす	あけはなす
あけはなつ	あけはなつ
あげひばり	あげひばり
あけひろげ	あけひろげ
あこがれる	あこがれる
あざわらう	あざわらう
あしからず	あしからず
あじけない	あじけない
あしざまに	あしざまに
あしてまとい	足手まとい
あずけいれる	預け入れる
あすぴりん	アスピリン
あせちれん	アセチレン
あせてえと	アセテート
あそびくらす	遊び暮らす
あたまでっかち	頭でっかち
あたりさわり	当たり触り
あたりまえ	あたりまえ
あつかましい	厚かましい
あっけない	あっけない
あっぷりけ	アップリケ
あつぼったい	厚ぼったい
あつらえる	あつらえる
あてこすり	当てこすり
あてこする	あてこする
あてつける	あてつける
あてはずれ	当てはずれ
あてはまる	あてはまる
あてはめる	あてはめる
あてられる	あてられる
あどけない	あどけない
あとのまつり	あとの祭り
あなうんす	アナウンス
あなをあける	穴をあける
あばきだす	あばき出す
あばずれおんな	あばずれ女
あぶながる	あぶながる
あぶらあげ	あぶらあげ
あぶらぜみ	あぶらぜみ
あぶらむし	あぶらむし
あぶらをしぼる	油をしぼる
あぶりだし	あぶり出し
あぶりだす	あぶり出す
あふれだす	あふれ出す
あふれでる	あふれ出る
あまがえる	あまがえる
あまずっぱい	甘酸っぱい
あまちゅあ	アマチュア
あまつさえ	あまつさえ
あまったるい	甘ったるい
あまやかす	あまやかす
あみあげぐつ	編み上げ靴
あみあげる	編みあげる
あらいざらし	洗いざらし
あらいさらす	洗いさらす
あらいたてる	洗い立てる
あらかじめ	あらかじめ
ありあわせ	あり合わせ
ありあわせ	有り合わせ
ありがたい	ありがたい
ありがとう	ありがとう
ありきたり	ありきたり
ありったけ	ありったけ
ありのまま	ありのまま
ありふれた	ありふれた
ありふれる	ありふれる
あるかりせい	アルカリ性
あるきまわる	歩きまわる
あるこおる	アルコール
あるばいと	アルバイト
あるまいと	アルマイト
あれはてる	荒れ果てる
あれるぎい	アレルギー
あわだてる	あわだてる
あわよくば	あわよくば
あんけえと	アンケート
あんこおる	アンコール
あんちゃん	あんちゃん
あんぱいあ	アンパイア
あんもにあ	アンモニア
いあわせる	居合わせる
いいあらわす	言い表わす
いいかえる	言い換える
いいかかえる	言い換える
いいがかり	言いがかり
いいかける	言いかける
いいかげん	いいかげん
いいかわす	言い交わす
いいしれる	言い知れる
いいすぎる	言い過ぎる
いいすてる	言い捨てる
いいたてる	言い立てる
いいちがえる	言い違える
いいつかる	言い付かる
いいつける	言い付ける
いいつたえる	言い伝える
いいなずけ	いいなづけ
いいなれる	言いなれる
いいなれる	言い慣れる
いいにくい	言いにくい
いいぬける	言い抜ける
いいふくめる	言い含める
いいふらす	言いふらす
いいまかす	言い負かす
いいまくる	言いまくる
いいまわし	言いまわし
いいもらし	言い漏らし
いいもらす	言いもらす
いいよどむ	言いよどむ
いえのころうとう	家の子郎党
いがぐりあたま	いがぐり頭
いがみあい	いがみあい
いがみあう	いがみあう
いかめしい	いかめしい
いきいきと	生き生きと
いきかかる	行きかかる
いきかける	行きかける
いきすぎる	行き過ぎる
いきどおる	いきどおる
いきのびる	生き延びる
いきりたつ	いきりたつ
いじっぱり	意地っ張り
いじらしい	いじらしい
いすくめる	射すくめる
いたずらに	いたずらに
いたみいる	いたみいる
いためつける	痛めつける
いたるところ	至るところ
いちどきに	いちどきに
いちはやく	いちはやく
いちゃつく	いちゃつく
いつくしむ	いつくしむ
いっさんかたんそ	一酸化炭素
いつまでも	いつまでも
いとおしい	いとおしい
いとけない	いとけない
いとしがる	いとしがる
いぶかしい	いぶかしい
いぶかしむ	いぶかしむ
いぶしだす	いぶし出す
いましめる	いましめる
いまわしい	忌まわしい
いみきらう	忌みきらう
いやしくも	いやしくも
いやしめる	いやしめる
いやしんぼう	いやしん坊
いやらしい	いやらしい
いやりんぐ	イヤリング
いりつける	煎り付ける
いりまじる	いりまじる
いりみだれる	入り乱れる
いれかえる	入れ替える
いれかわり	入れ替わり
いれかわる	入れ替わる
いれちがえる	入れ違える
いんきくさい	陰気くさい
いんきけし	インキ消し
ういすきい	ウイスキー
うえすとせん	ウエスト線
うえつける	植えつける
うかされる	浮かされる
うかれあるく	うかれ歩く
うきあがる	浮き上がる
うけいれる	受け入れる
うけつける	受けつける
うけとめる	受け止める
うごめかす	うごめかす
うさばらし	憂さ晴らし
うすきみわるい	薄気味悪い
うずくまる	うずくまる
うずだかい	うずだかい
うずもれる	うずもれる
うすよごれる	薄よごれる
うたいあげる	歌いあげる
うちあげる	うち上げる
うちあたる	打ち当たる
うちあてる	打ち当てる
うちおとす	打ち落とす
うちおろす	うちおろす
うちくだく	打ちくだく
うちこわし	打ちこわし
うちこわす	打ちこわす
うちすてる	打ち棄てる
うちたてる	打ち立てる
うちつける	打ちつける
うちとける	うちとける
うちのばす	打ち延ばす
うちのめす	打ちのめす
うちふところ	内ふところ
うちほろぼす	うち亡ぼす
うちよせる	打ち寄せる
うっちゃり	うっちゃり
うっちゃる	うっちゃる
うってつけ	うってつけ
うつぶせる	うつぶせる
うつむける	うつむける
うつりかわり	移り変わり
うつりかわる	移り変わる
うとんじる	うとんずる
うなされる	うなされる
うなだれる	うなだれる
うぬぼれる	うぬぼれる
うまれたて	生まれたて
うまれつき	生まれつき
うまれつく	生まれつく
うまれながら	生れながら
うみおとす	産み落とす
うみつける	産みつける
うめあわせ	埋め合わせ
うめたてる	埋め立てる
うらがれる	うら枯れる
うらにうむ	ウラニウム
うらめしい	うらめしい
うらめしがる	恨めしがる
うりあげげる	売り上げる
うりあげだか	売り上げ高
うりきれる	売り切れる
うりさばく	売りさばく
うりつける	売り付ける
うりとばす	売りとばす
うりひろめる	売り広める
うりまわる	売りまわる
うるませる	うるませる
うるわしい	うるわしい
うれしがらせ	嬉しがらせ
うれしがる	うれしがる
うろたえる	うろたえる
うろちょろ	うろちょろ
うわぐすり	うわぐすり
えきすとら	エキストラ
えげつない	えげつない
えごいすと	エゴイスト
えこひいき	えこひいき
えすきもお	エスキモー
えちけっと	エチケット
えっくすせん	エックス線
えっさっさ	エッサッサ
えねるぎい	エネルギー
えぴそおど	エピソード
えぼないと	エボナイト
えめらるど	エメラルド
えりすぐる	えりすぐる
えりわける	えり分ける
えれがんと	エレガント
えれめんと	エレメント
おいかける	追いかける
おいすがる	追いすがる
おいそれと	おいそれと
おいたてる	追い立てる
おいちらす	追い散らす
おいつめる	追いつめる
おいぼれる	老いぼれる
おいまわす	追いまわす
おおせつかる	仰せ付かる
おおせつける	仰せ付ける
おおつごもり	大つごもり
おおっぴら	おおっぴら
おおとばい	オートバイ
おおぶろしき	大ぶろしき
おかあさま	おかあさま
おかあさん	おかあさん
おかしがる	おかしがる
おかみさん	おかみさん
おきあがり	起き上がり
おきあがる	起き上がる
おきかえる	置き換える
おきごたつ	置きごたつ
おきしふる	オキシフル
おきにいり	お気に入り
おきみやげ	置きみやげ
おきわすれる	置き忘れる
おくたあぶ	オクターブ
おくゆかしい	奥ゆかしい
おくりつける	送りつける
おくりとどける	送り届ける
おくればせ	おくればせ
おこえがかり	お声がかり
おこりつける	怒りつける
おさななじみ	幼ななじみ
おしあける	押しあける
おしあげる	押し上げる
おしあてる	押し当てる
おじいさん	おじいさん
おしおよぼす	推し及ぼす
おしかける	押しかける
おしこめる	押し込める
おしさげる	押しさげる
おしすすめる	推し進める
おしたてる	押し立てる
おしつける	押しつける
おしつぶす	押しつぶす
おしつまる	押しつまる
おしつめる	押しつめる
おしつめる	押し詰める
おしなべて	おしなべて
おしのける	押しのける
おしのける	押し除ける
おしゃべり	おしゃべり
おしよせる	押し寄せる
おしわける	押し分ける
おせっかい	おせっかい
おそいかかる	襲いかかる
おそれいる	おそれいる
おちかかる	落ちかかる
おちかさなる	落ち重なる
おちつける	おちつける
おちのびる	落ちのびる
おちぶれる	落ちぶれる
おっかける	追っかける
おっこちる	おっこちる
おっことす	おっことす
おっしゃる	おっしゃる
おってがき	追って書き
おっとせい	おっとせい
おてやわらか	お手柔らか
おとうさま	おとうさま
おとうさん	おとうさん
おどしとる	おどし取る
おとなしい	おとなしい
おとなびる	おとなびる
おどりあがる	踊り上がる
おどりかかる	躍りかかる
おのおのがた	おのおの方
おのずから	おのずから
おのぼりさん	お上りさん
おばあさん	おばあさん
おびきだす	おびき出す
おびやかす	おびやかす
おぶらあと	オブラート
おぼろづきよ	おぼろ月夜
おみなえし	おみなえし
おめしかえ	お召し替え
おめでとう	おめでとう
おもいあがる	思いあがる
おもいあたる	思い当たる
おもいおこす	思い起こす
おもいおもいに	思い思いに
おもいがける	思いがける
おもいさだめる	思い定める
おもいすごす	思い過ごす
おもいちがえる	思い違える
おもいつめる	思いつめる
おもいのほか	思いのほか
おもわせぶり	思わせぶり
おりいって	おりいって
おりかさなる	折り重なる
おりかさねる	折り重ねる
おれんじいろ	オレンジ色
おわします	おわします
かいあげる	買い上げる
かいいれる	買い入れる
かいうける	買い受ける
かいかぶる	買いかぶる
かいきんしゃつ	開衿シャツ
かいしめる	買い占める
かいちゅう	かいちゅう
かいつまむ	かいつまむ
かいもとめる	買い求める
かうぼおい	カウボーイ
かうんたあ	カウンター
かえずぼん	替えズボン
かかえこむ	かかえこむ
かかえこむ	かかえ込む
かかりあい	かかりあい
かきあげる	書きあげる
かきあげる	書き上げる
かきあげる	掻き上げる
かきあつめる	かき集める
かきいれる	書き入れる
かきおろし	書き下ろし
かきしるす	書きしるす
かきそえる	書き添える
かきそんずる	書き損ずる
かきたてる	書き立てる
かきたてる	掻き立てる
かきちらす	書き散らす
かきつける	書きつける
かぎつける	かぎつける
かぎつける	嗅ぎつける
かきつばた	かきつばた
かきとめる	書きとめる
かきなぐる	書きなぐる
かぎほっく	かぎホック
かきまぜる	かきまぜる
かきまわす	かきまわす
かきむしる	かきむしる
かきもらす	書きもらす
かきよせる	かき寄せる
かきわける	かき分ける
かきわける	書き分ける
かぎわける	かぎ分ける
かぎわける	嗅ぎ分ける
かくしゃく	かくしゃく
かぐわしい	かぐわしい
かけくらべ	かけくらべ
かけっくら	かけっくら
かけつける	かけつける
かげながら	かげながら
かけぬける	かけ抜ける
かけはなれる	かけ離れる
かけまわる	かけまわる
かこつける	かこつける
かざりたてる	飾りたてる
かざりつける	飾りつける
かしおぺあ	カシオペア
かしこまる	かしこまる
かしつけける	貸し付ける
かじりつく	かじりつく
かすめとる	かすめ取る
かすりきず	かすりきず
かせいそおだ	苛性ソーダ
かぞえあげる	数えあげる
かぞえたてる	数え立てる
かぞえつくす	数え尽くす
かたがた	−かたがた
かたくりこ	かたくり粉
かたづける	かたづける
かたつむり	かたつむり
かたはらいたい	片腹いたい
かたぼうかつぐ	片棒かつぐ
かたみがひろい	肩身が広い
かたよせる	かたよせる
かたりあかす	語り明かす
かたりかける	語りかける
かちいくさ	勝ちいくさ
かっとばす	かっ飛ばす
かっぱらい	かっぱらい
かとりせんこう	蚊取り線香
かとりっく	カトリック
かどわかす	かどわかす
かなづかい	かなづかい
かなまじり	かなまじり
かぶとむし	かぶとむし
かぶりつく	かぶりつく
かみくだく	かみくだく
かみこなす	かみこなす
かみしめる	かみしめる
かみつぶす	かみつぶす
かみわける	かみ分ける
かむばっく	カムバック
かめらまん	カメラマン
かもしだす	かもし出す
がらすばり	ガラス張り
からすむぎ	からすむぎ
からだつき	からだつき
からっかぜ	からっかぜ
からみあう	からみ合う
からみつく	からみつく
がらんどう	がらんどう
かりあつめる	かり集める
かりいれる	刈り入れる
かりいれる	借り入れる
かりうける	借り受ける
かりたてる	かり立てる
かりたてる	駆り立てる
かるしうむ	カルシウム
かれすすき	枯れすすき
かれんだあ	カレンダー
かろうじて	かろうじて
かわいがる	かわいがる
かわいそう	かわいそう
かわらぶき	かわらぶき
かわりばえ	変わり栄え
かわりばんこ	替わり番こ
かんがみる	かんがみる
かんがるう	カンガルー
かんなづき	かんなづき
かんにんぐ	カンニング
かんばしい	かんばしい
きあわせる	来合わせる
きえうせる	消え失せる
ききいれる	聞き入れる
ききおとす	聞き落とす
ききかじる	聞きかじる
ききぐるしい	聞き苦しい
ききただす	聞きただす
ききちがえる	聞き違える
ききつける	聞きつける
ききつたえる	聞き伝える
ききどころ	聞きどころ
ききとどける	聞き届ける
ききなれる	聞き馴れる
ききもらす	聞きもらす
ききわける	聞き分ける
ききわすれる	聞き忘れる
ぎこちない	ぎこちない
きざみつける	刻み付ける
きずきあげる	築きあげる
きたいはずれ	期待はずれ
きたえあげる	鍜えあげる
きっての	−切っての
きまりもんく	きまり文句
きまりわるい	きまり悪い
きみがわるい	気味が悪い
きめつける	きめつける
ぎゃざあぶん	ギャザー分
きゃばれえ	キャバレー
きゃぷてん	キャプテン
きゃらめる	キャラメル
きゃんでえ	キャンデー
きゅうぎゅうのいちもう	九牛の一毛
きゅうぴい	キューピー
きょうだい	きょうだい
きょろつく	きょろつく
ぎょろつく	ぎょろつく
きらびやか	きらびやか
きらめかす	きらめかす
きりあげる	切り上げる
きりおとす	切り落とす
きりかえる	切り換える
きりかかる	斬りかかる
きりかける	切りかける
きりかわる	切り替わる
きりぎりす	きりぎりす
きりきりまい	きりきり舞
きりくずす	切りくずす
きりさげる	切り下げる
きりすてる	切り捨てる
きりすときょう	キリスト教
きりつける	切りつける
きりつめる	切りつめる
きりぬける	切り抜ける
きりひろげる	切り広げる
きりまわす	きりまわす
きろぐらむ	キログラム
きろわっと	キロワット
くいあらす	食い荒らす
くいあらためる	悔い改める
くいあわせ	食い合わせ
くいかかる	食いかかる
くいかける	食いかける
くいさがる	食いさがる
くいしばる	食いしばる
くいしんぼう	食いしん坊
くいたりる	食い足りる
くいちがう	くいちがう
くいちらす	食い散らす
くいつくす	食い尽くす
くいつぶし	食いつぶし
くいつぶす	食いつぶす
くいつめる	食いつめる
くいとめる	食い止める
くいのばし	食い延ばし
くいのばす	食い延ばす
くいはぐれ	食いはぐれ
くしけずる	くしけずる
ぐしょぬれ	ぐしょぬれ
くそおちつき	糞落ち着き
くたびれる	くたびれる
くだらない	くだらない
くつがえす	くつがえす
くつがえる	くつがえる
ぐっしょり	ぐっしょり
くっしょん	クッション
くっつける	くっつける
ぐっとくる	ぐっと来る
ぐっどばい	グッドバイ
くつろげる	くつろげる
くつわむし	くつわむし
くみあげる	汲み上げる
くみあわす	組み合わす
くみあわせ	組み合わせ
くみいれる	組み入れる
くみかえる	組み替える
くみたてる	組み立てる
くやしがる	くやしがる
くゆらせる	くゆらせる
ぐらいだあ	グライダー
くらいよう	食らい酔う
ぐらうんど	グラウンド
くらしっく	クラシック
くらしむき	暮らし向き
ぐらんぷり	グランプリ
くりあげる	繰り上げる
くりあわせ	繰り合わせ
くりいれる	繰り入れる
くりかえる	繰り替える
くりさげる	繰り下げる
くりすます	クリスマス
くりのべる	繰り延べる
くりひろげる	繰り広げる
くれかかる	暮れかかる
くれぐれも	くれぐれも
くろおばあ	クローバー
ぐろっきい	グロッキー
ぐろてすく	グロテスク
くわずぎらい	食わず嫌い
ぐんにゃり	ぐんにゃり
けおされる	気圧される
けしかける	けしかける
けしからん	けしからん
けしきばむ	けしきばむ
けしとめる	消し止める
けたちがい	けたちがい
けたはずれ	けたはずれ
けちくさい	けちくさい
けつまずく	けつまずく
げんごろう	げんごろう
けんする	検・験する
こいねがう	こいねがう
こうばしい	こうばしい
こうもりがさ	こうもり傘
こおちゃあ	コーチャー
ごおるでん	ゴールデン
こがねむし	こがねむし
こきおろす	こきおろす
こぎつける	こぎつける
こきまぜる	こきまぜる
こきみよい	小気味よい
こぎよせる	漕ぎ寄せる
こくのある	こくのある
こけおどし	こけおどし
こごえつく	こごえつく
ここかしこ	ここかしこ
こころやすだてに	心安立てに
ございます	ございます
こざかしい	小ざかしい
こざっぱり	小ざっぱり
ござります	ござります
こじあける	こじあける
こじつける	こじつける
こしらえる	こしらえる
こじらせる	こじらせる
こそばゆい	こそばゆい
こぢんまり	小ぢんまり
こっきり	−こっきり
ごったがえす	ごった返す
こていしさんぜい	固定資産税
こときれる	こときれる
ことごとく	ことごとく
ことづかる	ことづかる
ことづける	ことづける
こにくらしい	小憎らしい
こねまわす	こねまわす
このところ	このところ
このまがくれ	木の間隠れ
ごはさん	（御)破算
こびりつく	こびりつく
ごまのはえ	ごまのはえ
こまりはてる	困り果てる
こみあげる	こみあげる
こみゅにけ	コミュニケ
ごむてえぷ	ゴムテープ
こらしめる	こらしめる
こりかたまる	凝り固まる
これくらい	これくらい
こればかり	こればかり
ごろあわせ	語呂合わせ
ころげこむ	ころげ込む
ころげまわる	転げまわる
こんくうる	コンクール
こんさあと	コンサート
こんさいす	コンサイス
こんしいずん	今シーズン
こんせんと	コンセント
こんてすと	コンテスト
こんてなあ	コンテナー
こんでんす	コンデンス
こんにちは	こんにちは
こんにゃく	こんにゃく
こんばんは	こんばんは
さいどかあ	サイドカー
さえかえる	冴えかえる
さえわたる	冴えわたる
さがしあてる	探しあてる
さがしまわる	探しまわる
さがしもとめる	探し求める
さかだてる	さかだてる
さかのぼる	さかのぼる
さきおととい	先おととい
さきそろう	咲きそろう
さきにおう	咲きにおう
さきほこる	咲きほこる
さきみだれる	咲き乱れる
さぐりあてる	探りあてる
ささくれる	ささくれる
さざれいし	さざれいし
さしあたり	さしあたり
さしあたる	さしあたる
さしおさえる	差押さえる
さしかかる	さしかかる
さしさわる	さしさわる
さしせまる	さしせまる
さしたてる	差し立てる
さしちがえる	刺し違える
さしのべる	差し伸べる
さしはさむ	さしはさむ
さしむかい	差し向かい
さしむける	さしむける
さしわたし	さしわたし
させられる	させられる
さそいだす	さそい出す
さそいよせる	誘い寄せる
さっかりん	サッカリン
さつまいも	さつまいも
さとうきび	さとうきび
さなだむし	さなだむし
さようなら	さようなら
さらけだす	さらけ出す
さらされる	さらされる
さらでだに	さらでだに
さりげない	さりげない
さりげない	さり気ない
さるすべり	さるすべり
されこうべ	されこうべ
さわぎたてる	騒ぎ立てる
さんきゅう	サンキュー
さんしょう	さんしょう
しあさって	しあさって
しいたげる	しいたげる
じぇっとき	ジェット機
しぇぱあど	シェパード
しおらしい	しおらしい
しかたがない	仕方がない
しかたなしに	仕方なしに
しがみつく	しがみつく
しかるべき	しかるべき
しかれども	しかれども
しこうして	しこうして
しじみがい	しじみがい
しそこなう	しそこなう
したがって	したがって
したごしらえ	下ごしらえ
したたかもの	したたか者
したたらす	したたらす
したなめずり	舌なめずり
しつらえる	しつらえる
しなだれる	しなだれる
しにぞこない	死に損ない
しにたえる	死に絶える
じびいんこうか	耳鼻咽喉科
しびらせる	しびらせる
じふてりあ	ジフテリア
しぼりたて	しぼり立て
しみったれ	しみったれ
しめあげる	締めあげる
しめくくり	しめくくり
しめくくる	しめくくる
しめつける	しめつける
しめっぽい	湿めっぽい
じゃあじい	ジャージー
じゃがいも	じゃがいも
しゃがれる	しゃがれる
しゃくやく	しゃくやく
じゃけっと	ジャケット
しゃちほこ	しゃちほこ
しゃっきり	しゃっきり
しゃっくり	しゃっくり
しゃったあ	シャッター
しゃぼてん	しゃぼてん
しゃぼんだま	シャボン玉
じゃんぐる	ジャングル
しゃんそん	シャンソン
じゃんぱあ	ジャンパー
しゅうとめ	しゅうとめ
じゅうにしちょうちゅう	十二指腸虫
しょいこむ	しょいこむ
しょっぱい	しょっぱい
しょわせる	しょわせる
しょんぼり	しょんぼり
しりすぼまり	尻すぼまり
しるえっと	シルエット
じれったい	じれったい
しろうさぎ	しろうさぎ
しわがれる	しわがれる
じんえんまれな	人煙まれな
しんきくさい	辛気くさい
しんぐるはば	シングル幅
しんたいしょうがいし	身体障害者
すいあげる	吸い上げる
すいいれる	吸い入れる
すいつける	吸い付ける
ずうずうべん	ずうずう弁
すえおそろしい	末恐ろしい
すえたのもしい	末頼もしい
すえつける	据え付ける
すかあとだけ	スカート丈
すがりつく	すがりつく
すくいあげる	救い上げる
すくうたあ	スクーター
すくなからず	少なからず
すくなくとも	少なくとも
すくらっぷ	スクラップ
すくりいん	スクリーン
すくりゅう	スクリュー
すげかえる	すげ替える
すさまじい	すさまじい
すすりなき	すすり泣き
すすりなく	すすり泣く
すっすっと	すっすっと
すっぱぬき	すっぱぬき
すっぱぬく	すっぱぬく
すっぽかす	すっぽかす
すてぜりふ	捨てぜりふ
ずでんどう	ずでんどう
すとおりい	ストーリー
すとらいき	ストライキ
すとらいく	ストライク
すとりいと	ストリート
すねかじり	すねかじり
すばしこい	すばしこい
ずばぬける	ずばぬける
すばらしい	素晴らしい
すぴいかあ	スピーカー
すぷりんぐ	スプリング
すべからく	すべからく
すべくくる	統べくくる
すぺくとる	スペクトル
すべりこみ	すべり込み
すべりこむ	すべり込む
すべりだし	すべり出し
すぺりんぐ	スペリング
すぽんさあ	スポンサー
すみなれる	住みなれる
すみにくい	住みにくい
すらっくす	スラックス
すりあがる	刷りあがる
すりあがる	磨りあがる
すりあげる	磨りあげる
ずりおちる	ずり落ちる
すりかえる	すり換える
すりがらす	すりガラス
すりきれる	すりきれる
すりくだく	すりくだく
ずりさがる	ずりさがる
すりつける	すりつける
すりつぶす	すりつぶす
すりぬける	すり抜ける
すりへらす	すり減らす
すりむける	すりむける
すろおがん	スローガン
すわりこむ	すわりこむ
せいいっぱい	精いっぱい
せえらあふく	セーラー服
せおいなげ	背負い投げ
せきたてる	せきたてる
せきとめる	せきとめる
せきばらい	せきばらい
せけんしらず	世間知らず
ぜすちゃあ	ゼスチャー
せせらわらい	せせら笑い
せせらわらう	せせら笑う
せちがらい	せちがらい
せなかあわせ	背中合わせ
ぜみなある	ゼミナール
せめあぐむ	攻めあぐむ
せめおとす	攻め落とす
せめかかる	攻めかかる
せめかける	攻めかける
せめたてる	攻め立てる
せめたてる	責めたてる
せめつける	責めつける
せめほろぼす	攻め滅ぼす
せめよせる	攻め寄せる
せりあげる	せりあげる
せりあげる	せり上げる
せりおとす	せり落とす
せるろいど	セルロイド
せろふぁん	セロファン
せわしない	せわしない
せんじつめる	煎じつめる
ぞうりがけ	ぞうりがけ
そそのかし	そそのかし
そそのかす	そそのかす
そそりたつ	そそり立つ
そぞろあるき	そぞろ歩き
そだてあげる	育て上げる
そっけない	そっけない
そっちのけ	そっちのけ
そなえつける	備えつける
そなえつける	備え付ける
そのばかぎり	その場限り
そばだてる	そばだてる
そびやかす	そびやかす
そびれる	−そびれる
そめあがり	染め上がり
そめあげる	染めあげる
そめつける	染めつける
そめわける	染め分ける
そらおそろしい	空恐ろしい
そらんずる	そらんずる
そりおとす	そり落とす
そりおとす	剃り落とす
それくらい	それくらい
それっきり	それっきり
それとなく	それとなく
たいぴすと	タイピスト
だいれくと	ダイレクト
だきあげる	抱き上げる
だきあわせ	抱き合わせ
だきおこす	抱き起こす
たきしめる	焚きしめる
だきしめる	だきしめる
だきしめる	抱きしめる
たきつける	焚きつける
だきとめる	抱き止める
だきよせる	抱き寄せる
たくましい	たくましい
たけりたつ	たけりたつ
だけれども	だけれども
だしおしみ	出し惜しみ
だししぶる	出ししぶる
たしなめる	たしなめる
たすきがけ	たすきがけ
たたききる	たたき切る
たたきこむ	たたき込む
たたきだす	たたき出す
たたずまい	たたずまい
たたみかける	畳みかける
たちあがり	立ち上がり
たちあがる	立ち上がる
たちすくむ	立ちすくむ
たちつづける	立ち続ける
たちどまる	立ち止まる
たちのぼる	立ちのぼる
たちはばとび	立ち幅跳び
たちまわる	立ちまわる
たちむかう	立ち向かう
たてかえる	立て替える
たてかける	立てかける
たてかける	立て掛ける
たてこもる	立てこもる
たてつづけに	立て続けに
たどりつく	たどりつく
たなおろし	たなおろし
たなごころ	たなごころ
たぶらかす	たぶらかす
たべつける	食べつける
だましうち	だまし討ち
たまらない	たまらない
たむろする	たむろする
だらしない	だらしない
たれさがる	垂れ下がる
たわいない	たわいない
たわむれる	たわむれる
たんばりん	タンバリン
だんぴんぐ	ダンピング
ちぇりすと	チェリスト
ちからいっぱい	力いっぱい
ちきゅうかんそくねん	地球観測年
ちぢこまる	ちぢこまる
ちゃっかり	ちゃっかり
ちゃのみともだち	茶飲み友達
ちゃぶだい	ちゃぶだい
ちゃんばら	ちゃんばら
ちゃんぽん	ちゃんぽん
ちゅうおうかこうきゅう	中央火口丘
ちゅうぶらりん	宙ぶらりん
ちょこっと	ちょこっと
ちょこんと	ちょこんと
ちょっきり	ちょっきり
ちょっぴり	ちょっぴり
ちょんぎる	ちょんぎる
ちょんまげ	ちょんまげ
ちりあくた	ちりあくた
ちりばめる	ちりばめる
ちんどんや	チンドン屋
つうぴいす	ツーピース
つかいこなす	使いこなす
つかいならす	使い慣らす
つかいなれる	使い慣れる
つかいはたす	使い果たす
つかいわける	使い分ける
つかさどる	つかさどる
つかまえる	つかまえる
つかみあい	つかみ合い
つかみあう	つかみあう
つかみだす	つかみ出す
つかみどり	つかみ取り
つきあげる	つきあげる
つきあたり	突き当たり
つきあたる	つき当たる
つきあてる	つき当てる
つきあわせ	つきあわせ
つきおとす	突き落とす
つきかかる	つきかかる
つきかためる	搗き固める
つきつける	つきつける
つきつめる	突き詰める
つきとばす	つき飛ばす
つきとめる	つきとめる
つきぬける	突き抜ける
つきのける	突きのける
つきはてる	尽き果てる
つきまとう	つきまとう
つきみそう	つきみそう
つくねんと	つくねんと
つくりあげる	作りあげる
つくりあげる	作り上げる
つくりかえる	作り替える
つけあがる	つけあがる
つけかえる	付け替える
つけくわえる	付け加える
つけくわわる	付け加わる
つけどまり	付けどまり
つけねらう	つけねらう
つけはなし	つけはなし
つけまわす	つけまわす
つけやきば	つけ焼き刃
つっかかる	つっかかる
つっかける	つっかける
つつがない	つつがない
つづけざまに	続けざまに
つっぱなす	つっぱなす
つっぱねる	つっぱねる
つつましい	つつましい
つづらおり	つづら折り
つのづきあい	角突きあい
つまされる	つまされる
つまだてる	つまだてる
つまはじき	つまはじき
つまびらか	つまびらか
つまみぐい	つまみ食い
つまみだす	つまみ出す
つまみもの	つまみもの
つまらない	つまらない
つみあげる	積み上げる
つみかえる	積み換える
つみかさなる	積み重なる
つみかさねる	積み重ねる
つみたてる	積み立てる
つめかける	詰めかける
つめかける	詰め替える
つりあがる	つり上がる
つりあげる	つり上げる
つりさげる	つり下げる
つるべうち	つるべ射ち
つんのめる	つんのめる
てあしまとい	手足まとい
でぃいぜる	ディーゼル
ていっぱい	手いっぱい
でかだんす	デカダンス
できあがり	出来上がり
できあがる	出来上がる
てきびしい	手きびしい
てくにっく	テクニック
でくのぼう	でくのぼう
でざいなあ	デザイナー
でしゃばり	出しゃばり
でしゃばる	出しゃばる
でずいらず	出ず入らず
てなずける	手なづける
てばしこい	手ばしこい
でらっくす	デラックス
てりつける	照りつける
てりはえる	照りはえる
てれくさい	照れくさい
てれたいぷ	テレタイプ
てをいれる	手を入れる
てんてこまい	てんてこ舞
てんねんきねんぶつ	天然記念物
といあわす	問い合わす
といかける	問いかける
といただす	問いただす
といつめる	問いつめる
といれっと	トイレット
とうがらし	とうがらし
どうしても	どうしても
とおりいっぺん	通り一ぺん
とおりがかり	通りがかり
とおりがかる	通りかかる
とおりすがり	通りすがり
とおりすぎる	通り過ぎる
とおりぬける	通り抜ける
とがらかす	とがらかす
とぎすます	研ぎすます
ときふせる	説き伏せる
ところきらわず	所きらわず
とじこめる	閉じこめる
とじこもる	閉じこもる
とじつける	とじつける
どじをふむ	どじを踏む
どすぐろい	どすぐろい
とっちめる	とっちめる
とっておき	取っておき
とってかえす	取って返す
とどろかす	とどろかす
となりあわせ	隣り合わせ
どなりこむ	どなりこむ
どのように	どのように
とばっちり	とばっちり
とびあがる	飛び上がる
とびおきる	とび起きる
とびおりる	飛びおりる
とびかかる	とびかかる
とびこえる	飛び越える
とびはなれる	飛び離れる
とびまわる	とびまわる
とめどなく	とめどなく
ともすると	ともすると
ともすれば	ともすれば
ともどもに	ともどもに
とらくたあ	トラクター
とらこおま	トラコーマ
とらほおむ	トラホーム
どらむかん	ドラムカン
とらわれる	とらわれる
とりあえず	とりあえず
とりあげる	取りあげる
とりあげる	取り上げる
とりあわせ	取り合わせ
とりいれる	取り入れる
とりうちぼうし	鳥打ち帽子
とりおとす	取り落とす
とりかえる	取り換える
とりかかる	取りかかる
とりかたづけ	取り片付け
とりかわす	取り交わす
とりきめる	取りきめる
とりこしぐろう	取越し苦労
とりこぼし	とりこぼし
とりこぼす	取りこぼす
とりこわし	取りこわし
とりこわす	取りこわす
とりさげる	取り下げる
とりさばく	取りさばく
とりしきる	取りしきる
とりしまる	取り締まる
とりしらべる	取り調べる
とりすがる	とりすがる
とりたてる	取り立てる
とりちがえる	取り違える
とりちらす	取り散らす
とりつくす	取り尽くす
とりつける	取りつける
とりつける	取り付ける
とりとめる	取り止める
とりにがす	取り逃がす
とりのける	取り除ける
とりはからう	取り計らう
とりはずす	とりはずす
とりはずす	取りはずす
とりまぜる	とりまぜる
とりまとめ	取りまとめ
とりみんぐ	トリミング
とりよせる	取り寄せる
どれっしい	ドレッシー
どんぶりこ	どんぶりこ
ないがしろ	ないがしろ
ながたらしい	長たらしい
なかまはずれ	仲間はずれ
ながめまわす	眺めまわす
なきあかす	泣き明かす
なきおとし	泣き落とし
なきかわす	鳴きかわす
なきくらす	泣き暮らす
なきねいり	泣き寝入り
なぐさめる	なぐさめる
なぐりあい	なぐり合い
なぐりがき	なぐり書き
なぐりころす	なぐり殺す
なぐりたおす	なぐり倒す
なげいれる	投げ入れる
なげかける	投げかける
なげかわしい	嘆かわしい
なげすてる	投げすてる
なげすてる	投げ棄てる
なげつける	投げつける
なしくずし	なしくずし
なしとげる	なし遂げる
なぞらえる	なぞらえる
なつかしい	なつかしい
なつかしむ	なつかしむ
なってない	なってない
なつみかん	なつみかん
なでつける	なでつける
なでまわす	なでまわす
なとりうむ	ナトリウム
なにくわぬかお	何食わぬ顔
なのりでる	名乗り出る
なふたりん	ナフタリン
なまじいに	なまじいに
なまじっか	なまじっか
なまやさしい	生やさしい
なみうちぎわ	波うちぎわ
なみだぐましい	涙ぐましい
ならべたてる	並べたてる
なりあがる	成り上がる
なりかわる	成りかわる
なりさがる	成り下がる
なりはてる	なり果てる
なりものいり	鳴り物入り
なれそめる	なれそめる
なれのはて	なれの果て
なんせんす	ナンセンス
なんなんとする	垂んとする
におわせる	におわせる
にがみばしる	苦みばしる
にぎりこぶし	握りこぶし
にぎりしめる	握りしめる
にぎりつぶし	握りつぶし
にぎりつぶす	握りつぶす
にくたらしい	憎たらしい
にげうせる	逃げ失せる
にげのびる	逃げのびる
にげまどう	逃げまどう
にげまわる	逃げまわる
にごしらえ	荷ごしらえ
にしきへび	にしきへび
にじほうていしき	二次方程式
にじみでる	にじみ出る
にじりよる	にじり寄る
にひゃくはつか	二百二十日
にひりすと	ニヒリスト
にゅあんす	ニュアンス
にょっきり	にょっきり
にらまえる	にらまえる
にらまれる	にらまれる
にらみあい	にらみ合い
にらみあう	にらみあう
にらみかえす	にらみ返す
にらめっこ	にらめっこ
ぬいつける	縫いつける
ぬいどまり	縫いどまり
ぬぎすてる	脱ぎすてる
ぬぎすてる	脱ぎ棄てる
ぬきんでる	ぬきんでる
ぬけかわる	抜け変わる
ぬりあげる	塗りあげる
ぬりかえる	塗り替える
ぬりたくる	塗りたくる
ぬりたてる	塗り立てる
ぬりつける	塗りつける
ぬりつぶす	塗りつぶす
ぬれそぼつ	濡れそぼつ
ぬれねずみ	ぬれねずみ
ねいりばな	寝入りばな
ねえしょん	ネーション
ねがいさげる	願い下げる
ねこなでごえ	ねこなで声
ねこやなぎ	ねこやなぎ
ねじふせる	ねじ伏せる
ねじまげる	ねじ曲げる
ねじまわし	ねじまわし
ねそびれる	寝そびれる
ねたましい	ねたましい
ねとぼける	寝とぼける
ねばっこい	ねばっこい
ねばりづよい	ねばり強い
ねめつける	ねめつける
ねらいうち	ねらい撃ち
ねりかためる	練り固める
ねりはみがき	練り歯磨き
ねんがらねんじゅう	年がら年中
のいろおぜ	ノイローゼ
のこりおしい	残り惜しい
のしあがる	のし上がる
のしあげる	のし上げる
のしかかる	のしかかる
のたれじに	のたれ死に
のびあがる	伸び上がる
のみかける	飲みかける
のみならず	のみならず
のりあげる	乗り上げる
のりあわす	乗り合わす
のりいれる	乗り入れる
のりかえる	乗り換える
のりかかる	乗りかかる
のりこえる	乗り越える
のりすごす	乗り過ごす
のりすてる	乗り捨てる
のりつける	乗りつける
のりならす	乗り慣らす
のりなれる	乗り慣れる
のりまわす	乗りまわす
ぱあせんと	パーセント
ぱあてぃい	パーティー
はあもにい	ハーモニー
はあもにか	ハーモニカ
はいあがる	はい上がる
ばいおりん	バイオリン
はいきんぐ	ハイキング
はいねっく	ハイネック
ぱいぴんぐ	パイピング
はいまわる	はいまわる
はいりこむ	はいり込む
ぱいろっと	パイロット
ばかくさい	ばかくさい
ばからしい	ばからしい
はかりごと	はかりごと
はききよめる	掃き清める
はきすてる	掃き棄てる
はきすてる	掃き捨てる
はきちがえる	はき違える
ばくちうち	ばくちうち
ばくちうち	ばくち打ち
はくちょう	はくちょう
ばくてりあ	バクテリア
はぐらかす	はぐらかす
はぐれる	−はぐれる
はげいとう	はげいとう
はさみうち	はさみうち
はじきだす	はじき出す
ばじきだす	はじき出す
はしりたかとび	走り高跳び
はしりはばとび	走り幅跳び
はしりまわる	走りまわる
はずかしい	恥ずかしい
ばすけっと	バスケット
ばするうむ	バスルーム
はせつける	はせつける
はだかむぎ	はだかむぎ
はたしあい	果たし合い
はたらきかける	働きかける
はちあわせ	はち合わせ
はちきれる	はちきれる
はっけよい	ハッケヨイ
ばってりい	バッテリー
はっとする	はっとする
はてしない	はてしない
ぱとろおる	パトロール
はとろんし	ハトロン紙
はなしかける	話しかける
はなにかける	鼻にかける
はねあがる	はね上がる
はねあげる	はね上げる
はねおきる	はね起きる
はねかえす	はねかえす
はねかえる	はねかえる
はねつける	はねつける
はねとばす	はね飛ばす
はねのける	はねのける
はねまわる	はねまわる
はまだらか	はまだらか
はまりこむ	はまりこむ
はやいものがち	早い者勝ち
はやのみこみ	早のみ込み
はやりかぜ	はやりかぜ
はやりっこ	はやりっ子
はらいさげる	払い下げる
はらいっぱい	腹いっぱい
はらごしらえ	腹ごしらえ
はらだたしい	腹立たしい
ぱらちふす	パラチフス
はりあげる	張り上げる
はりかえる	張り替える
ばりけえど	バリケード
はりさける	張り裂ける
はりつける	はりつける
はりつめる	はりつめる
はりとばす	はり飛ばす
はれあがる	腫れあがる
はれあがる	晴れ上がる
ばれいしょ	ばれいしょ
はんだづけ	ハンダ付け
はんでぃい	ハンディー
はんもっく	ハンモック
ぴあにすと	ピアニスト
ぴいなっつ	ピーナッツ
ひがないちにち	日がな一日
ひからびる	干からびる
ひがんばな	ひがんばな
ひきあげる	引き上げる
ひきあげる	引き揚げる
ひきあわす	ひきあわす
ひきあわせ	ひきあわせ
ひきいれる	引き入れる
ひきうける	引き受ける
ひきおこす	ひき起こす
ひきおろす	引きおろす
ひきかえる	引き換える
ひきがえる	ひきがえる
ひきこもる	引きこもる
ひきさがる	引き下がる
ひきさげる	引き下げる
ひきしぼる	ひきしぼる
ひきしまる	ひきしまる
ひきしめる	ひきしめる
ひきしめる	引き締める
ひきたてる	引き立てる
ひきつける	ひきつける
ひきつける	引き付ける
ひきつれる	引き連れる
ひきとめる	引き止める
ひきのばし	引き伸ばし
ひきのばす	引き伸ばす
ひきまわす	ひきまわす
ひきよせる	引き寄せる
ひきわける	引き分ける
ひきわりむぎ	ひきわり麦
ぴくにっく	ピクニック
ひけらかす	ひけらかす
ひざがしら	ひざがしら
ひざまずく	ひざまずく
ひしひしと	ひしひしと
ひしゃげる	ひしゃげる
びしょぬれ	びしょぬれ
びすけっと	ビスケット
ひすてりい	ヒステリー
ひだりぎっちょ	左ぎっちょ
ひっかかる	ひっかかる
ひっかける	ひっかける
ひっかつぐ	ひっかつぐ
ひっかぶる	ひっかぶる
ひっくくる	ひっくくる
ひっこぬく	ひっこ抜く
ひっこます	ひっこます
ひっこみじあん	引込み思案
ひっこめる	ひっこめる
ひっさげる	ひっさげる
ひつじさる	ひつじさる
ぴっしゃり	ぴっしゃり
びっしょり	びっしょり
ひっそりかん	ひっそり閑
ひったくり	ひったくり
ひったくる	ひったくる
ひったてる	引っ立てる
ぴっちゃあ	ピッチャー
ひっつかむ	ひっつかむ
ひっつける	ひっつける
ひっぱたく	ひっぱたく
ひとかたならず	一方ならず
ひとしきり	ひとしきり
ひとすじに	ひとすじに
ひとつめこぞう	一つ目小憎
ひとところ	ひとところ
ひとなつこい	人なつこい
ひとりあるき	ひとり歩き
ひとりぎめ	ひとり決め
ひとりごと	ひとりごと
ひとりじめ	ひとり占め
ひとりずもう	独りずもう
ひとりでに	ひとりでに
ひとりぶたい	ひとり舞台
ひとりむし	ひとりむし
ひとわたり	ひとわたり
ひねくれる	ひねくれる
ひねこびる	ひねこびる
ひねりだす	ひねり出す
ひのえうま	ひのえうま
ひびきわたる	響きわたる
ひやしんす	ヒヤシンス
びやほおる	ビヤホール
ひょうたん	ひょうたん
ひょっくり	ひょっくり
ひょっこり	ひょっこり
ひょっとこ	ひょっとこ
ひょろながい	ひょろ長い
ひらあやまり	平あやまり
ぴらみっど	ピラミッド
ひらめかす	ひらめかす
ひるがえす	ひるがえす
ひるがえる	ひるがえる
ひろいあげる	拾いあげる
ひろいあげる	拾い上げる
ぴんせっと	ピンセット
ぴんとくる	ぴんと来る
ひんまがる	ひんまがる
ひんまげる	ひんまげる
ふぁすなあ	ファスナー
ふぃいるど	フィールド
ふぃよるど	フィヨルド
ふぃるたあ	フィルター
ふうじこめる	封じ込める
ふがいない	腑甲斐ない
ふかしたて	ふかしたて
ふきあがる	吹き上がる
ふきあげる	吹き上げる
ふきあれる	吹き荒れる
ふきおろす	吹きおろす
ふきかえる	吹き替える
ふきかける	吹きかける
ふききよめる	拭き清める
ふきさらし	吹きさらし
ふきだまり	吹きだまり
ふきつける	吹きつける
ふきとばす	吹き飛ばす
ふきまくる	吹きまくる
ふきよせる	吹き寄せる
ふくらしこ	ふくらし粉
ふくらはぎ	ふくらはぎ
ふくらます	ふくらます
ふさぎこむ	ふさぎこむ
ふさわしい	ふさわしい
ふしくれだつ	節くれ立つ
ふしまろぶ	伏しまろぶ
ふせどめる	伏せ止める
ぶちこわし	ぶちこわし
ぶちこわす	ぶちこわす
ぶちまける	ぶちまける
ぶったぎる	ぶったぎる
ぶっつかる	ぶっつかる
ぶっつける	ぶっつける
ふつりあい	不つりあい
ふみあらす	踏み荒らす
ふみいれる	踏み入れる
ふみかためる	踏み固める
ふみこえる	踏み越える
ふみしだく	踏みしだく
ふみしめる	踏みしめる
ふみつける	踏みつける
ふみつぶす	踏みつぶす
ふみならす	踏み鳴らす
ふみにじる	踏みにじる
ふみはずす	踏みはずす
ふらいぱん	フライパン
ぷらかあど	プラカード
ぶらさがる	ぶらさがる
ぶらさげる	ぶらさげる
ふらっしゅ	フラッシュ
ぶらっしゅ	ブラッシュ
ふらっぱあ	フラッパー
ふらんすご	フランス語
ふりあげる	振り上げる
ふりおこす	振り起こす
ふりおとす	振り落とす
ふりおろす	振りおろす
ふりかえる	ふりかえる
ふりかえる	振り替える
ふりかかる	ふりかかる
ふりかける	ふりかける
ふりかざす	ふりかざす
ふりかぶる	ふりかぶる
ふりこめる	降り込める
ふりしきる	降りしきる
ふりすてる	ふり棄てる
ふりそそぐ	降りそそぐ
ふりたてる	振り立てる
ふりつける	振り付ける
ふりつもる	降り積もる
ふりまわす	ふりまわす
ふりまわす	振りまわす
ふりむける	ふりむける
ふりわける	ふり分ける
ぷりんせす	プリンセス
ぶるじょあ	ブルジョア
ふるめかしい	古めかしい
ぷれえやあ	プレーヤー
ぷれぜんと	プレゼント
ふれまわる	ふれまわる
ぷれみあむ	プレミアム
ぶろおかあ	ブローカー
ぷろぐらむ	プログラム
ぷろふぃる	プロフィル
ぷろぺらあ	プロペラー
ふんだくる	ふんだくる
ふんだんに	ふんだんに
ぶんなぐる	ぶんなぐる
べありんぐ	ベアリング
へくたある	ヘクタール
へこたれる	へこたれる
べすとてん	ベストテン
べすとわん	ベストワン
ぺちゃんこ	ぺちゃんこ
ぺったらこ	ぺったらこ
ぺにしりん	ペニシリン
へばりつく	へばりつく
へりくだる	へりくだる
ぺんねえむ	ペンネーム
ぼいこっと	ボイコット
ほうせんか	ほうせんか
ほうだい	−ほうだい
ほうりこむ	ほうり込む
ほうりだす	ほうり出す
ほえたてる	ほえたてる
ほおかぶり	ほおかぶり
ほおかむり	ほおかむり
ほおむらん	ホームラン
ほかならぬ	ほかならぬ
ぼくしんぐ	ボクシング
ほくそえむ	ほくそえむ
ぽけっとぐち	ポケット口
ほころばす	ほころばす
ほころびる	ほころびる
ほしいまま	ほしいまま
ほしうらない	星うらない
ほだされる	ほだされる
ほたるがり	ほたる狩り
ほったてごや	掘立て小屋
ぽつねんと	ぽつねんと
ほつれどめ	ほつれ止め
ほととぎす	ほととぎす
ほとばしる	ほとばしる
ほのめかす	ほのめかす
ぽぴゅらあ	ポピュラー
ほめことば	ほめことば
ほめそやす	ほめそやす
ほめたてる	ほめたてる
ほめちぎる	ほめちぎる
ほりあてる	掘り当てる
ほりおこす	掘り起こす
ほりくずす	掘りくずす
ほりさげる	掘りさげる
ほりだしもの	掘り出し物
ほりつける	彫りつける
ほりつける	彫り付ける
ぼんのくぼ	ぼんのくぼ
まあけっと	マーケット
まあじゃん	マージャン
まいあがる	舞い上がる
まえすかあと	前スカート
まがりなり	曲がりなり
まきあがる	巻き上がる
まきあげる	まきあげる
まきあげる	巻きあげる
まきあげる	巻き上げる
まきおこす	まき起こす
まきおこる	まき起こる
まきたばこ	巻きたばこ
まきちらす	撒き散らす
まきつける	まきつける
まきつける	蒔きつける
まぎれこむ	まぎれ込む
まけいくさ	負けいくさ
まけおしみ	負け惜しみ
まけがこむ	負けがこむ
まけぎらい	負けぎらい
ますげえむ	マスゲーム
ますこっと	マスコット
まぜかえす	まぜかえす
またいとこ	またいとこ
またどおる	マタドール
まだるこい	まだるこい
まちあぐむ	待ちあぐむ
まちあわせ	待ち合わせ
まちうける	待ち受ける
まちかねる	待ちかねる
まちかまえる	待ち構える
まちどおしい	待ち遠しい
まちぼうけ	待ちぼうけ
まちもうける	待ち設ける
まちわびる	待ちわびる
まっさあじ	マッサージ
まっしぐら	まっしぐら
まっぱだか	まっぱだか
まつりあげる	祭り上げる
まにあわせ	間に合わせ
まぬがれる	まぬがれる
まのあたり	まのあたり
まよねえず	マヨネーズ
まるっきり	まるっきり
まるはだか	まるはだか
まるめこむ	まるめこむ
まんどりん	マンドリン
みあらわす	見あらわす
みあわせる	見合わせる
みおとりする	見劣りする
みおぼえる	見おぼえる
みがきあげる	磨きあげる
みがきたてる	磨き立てる
みごしらえ	身ごしらえ
みことのり	みことのり
みずしらず	見ず知らず
みずすまし	みずすまし
みずのみびゃくしょう	水呑み百姓
みせかける	見せかける
みせつける	見せつける
みそさざい	みそさざい
みそっかす	味噌っかす
みだしなみ	身だしなみ
みづくろい	身づくろい
みっしょん	ミッション
みとがめる	見とがめる
みのふりかた	身の振り方
みまちがえる	見間違える
みもだえる	身もだえる
みやびやか	みやびやか
みりばある	ミリバール
むかいあい	向かい合い
むかいあう	向かいあう
むぎわらざいく	麦わら細工
むぎわらぼうし	麦わら帽子
むこういき	向こう意気
むしりとる	むしりとる
むずかしい	むずかしい
むずがゆい	むずがゆい
むすびつける	結びつける
むせびなく	むせび泣く
むだづかい	むだづかい
むつかしい	むつかしい
むつまじい	むつまじい
むなくそわるい	胸くそ悪い
むなつきはっちょう	胸突き八丁
むべなるかな	宜なるかな
めあわせる	めあわせる
めかにずむ	メカニズム
めぐりあい	めぐりあい
めぐりあう	めぐりあう
めざましい	目ざましい
めしあがる	召しあがる
めしかかえる	召し抱える
めっせえじ	メッセージ
めったうち	めった撃ち
めりけんこ	メリケン粉
めろでぃい	メロディー
めをみはる	目をみはる
めんくらう	めんくらう
めんどうくさい	面倒くさい
もうけしごと	もうけ仕事
もうしあげる	申し上げる
もうしあわせ	申し合わせ
もうしいれる	申し入れる
もうしうける	申し受ける
もうしそえる	申し添える
もうしたてる	申し立てる
もうしつける	申し付ける
もうしのべる	申し述べる
もえあがる	燃え上がる
もえさかる	燃えさかる
もえつきる	燃えつきる
もえひろがる	燃え広がる
もおにんぐ	モーニング
もぐりこむ	もぐり込む
もちあがる	持ち上がる
もちあげる	持ち上げる
もちあわせ	持ち合わせ
もちあわせる	持ち合わせ
もちかえる	持ち換える
もちかける	もちかける
もちきたす	持ち来たす
もちぐされ	持ちぐされ
もちまわる	持ちまわる
もっけのさいわい	もっけの幸
もっていく	持っていく
もってくる	持ってくる
もってのほか	以てのほか
もてあそび	もてあそび
もてあそぶ	もてあそぶ
もてあまし	持てあまし
もてあます	もてあます
もてはやす	もてはやす
もどかしい	もどかしい
ものすごい	ものすごい
ものたりない	物足りない
もののあわれ	物のあわれ
ものはづけ	ものは付け
ものやわらか	物やわらか
もりあがる	盛り上がる
もりあげる	盛り上げる
もりつぶす	盛りつぶす
もるもっと	モルモット
やえざくら	やえざくら
やかましい	やかましい
やきすてる	焼き棄てる
やきつける	焼きつける
やきつける	焼き付ける
やきなまし	焼きなまし
やけおちる	焼け落ちる
やすうけあい	安受け合い
やすやすと	やすやすと
やせおとろえる	やせ衰える
やせこける	やせこける
やせっぽち	やせっぽち
やつあたり	八つ当たり
やつぎばやに	矢つぎ早に
やっつける	やっつける
やってくる	やってくる
やっとこさ	やっとこさ
やにさがる	やにさがる
やぶにらみ	やぶにらみ
やぶれかぶれ	破れかぶれ
やまざくら	やまざくら
やまのいも	やまのいも
やみあがり	病み上がり
やみがたい	やみがたい
ややこしい	ややこしい
やりきれる	やりきれる
やりこめる	やりこめる
やりすごす	やり過ごす
やりとげる	やり遂げる
やるせない	やるせない
やわらげる	やわらげる
ゆうとぴあ	ユートピア
ゆきあたり	行き当たり
ゆきあたる	行き当たる
ゆきがかり	行きがかり
ゆきかかる	行きかかる
ゆきかける	行きかける
ゆきすぎる	行き過ぎる
ゆきづまり	行き詰まり
ゆきづまる	行き詰まる
ゆきどまり	行き止まり
ゆくりなく	ゆくりなく
ゆすぶれる	ゆすぶれる
ゆずりうける	譲り受ける
ゆであがる	ゆであがる
ゆでたまご	ゆでたまご
ゆにほおむ	ユニホーム
ゆりあげる	揺り上げる
ゆりうごかす	揺り動かす
ゆりおこす	揺り起こす
よいしれる	酔いしれる
よおくづけ	ヨーク付け
よおろっぱ	ヨーロッパ
よこぐるまをおす	横車を押す
よしずばり	よしず張り
よじのぼる	よじのぼる
よせあつめる	寄せ集める
よせつける	寄せ付ける
よっぱらい	酔っぱらい
よっぱらう	酔っぱらう
よつんばい	四つんばい
よびあげる	呼びあげる
よびあつめる	呼び集める
よびいれる	呼び入れる
よびおこす	呼び起こす
よびかける	呼びかける
よびたてる	呼び立てる
よびつける	呼びつける
よびつづける	呼び続ける
よびとめる	呼び止める
よびならす	呼び慣らす
よびなれる	呼び慣れる
よびにくい	呼びにくい
よびよせる	呼び寄せる
よみあげる	読み上げる
よみあわせ	読み合わせ
よみがえる	よみがえる
よみこなす	読みこなす
よみなれる	読みなれる
よみふける	読みふける
よもすがら	よもすがら
よりあつまり	寄り集まり
よりあつまる	寄り集まる
よりかかる	よりかかる
よりかかる	寄りかかる
よりわける	より分ける
よろしゅう	よろしゅう
よわりはてる	弱りはてる
らいちょう	らいちょう
らいにんぐ	ライニング
らっかせい	らっかせい
らっきょう	らっきょう
らっせるしゃ	ラッセル車
らっぱのみ	ラッパ呑み
らぶしいん	ラブシーン
らんでぶう	ランデブー
らんどせる	ランドセル
らんにんぐ	ランニング
りありずむ	リアリズム
りっすいのよち	立錐の余地
れすとらん	レストラン
れすりんぐ	レスリング
れふぇりい	レフェリー
れんげそう	れんげそう
れんとげん	レントゲン
ろおしょん	ローション
ろおたりい	ロータリー
ろくおんてえぷ	録音テープ
わいしゃつ	ワイシャツ
わからずや	わからずや
わかりきる	わかりきる
わきあがる	わきあがる
わきあがる	沸き上がる
わきおこる	わき起こる
わきまえる	わきまえる
わしづかみ	わしづかみ
わずらわす	わずらわす
わだかまり	わだかまり
わだかまる	わだかまる
わっしょい	ワッショイ
わびずまい	わび住まい
わらじばき	わらじばき
わりあてる	割り当てる
わりいれる	割り入れる
わりきれる	割り切れる
わりつける	割り付ける
わりほぐす	割りほぐす
わんぴいす	ワンピース
